aa	t	ana
abaria	b	
abdomina	b	
abdonina	b	
abdulia	b	
abeiba	b	
abeja	b	
abelina	b	
abicena	b	
abicina	b	
abigael	b	
abigail	b	
abilia	b	
abirl	t	abril
ablina	b	
abnril	t	abril
abril	b	
abrilq	t	abril
abriñ	t	abril
abrl	t	abril
acelina	b	
acencion	b	
acened	b	
acenet	b	
aceneth	b	
aceney	b	
acension	b	
aciscla	b	
acista	b	
ada	b	
adaina	b	
adala	b	
adalfia	b	
adalgira	b	
adalgisa	b	
adalgiza	b	
adalguiza	b	
adali	b	
adalia	b	
adalila	b	
adalina	b	
adalinda	b	
adaliria	b	
adaly	b	
adalya	b	
adamis	b	
adayme	b	
adda	b	
addy	b	
adegy	b	
adeina	b	
adel	b	
adela	b	
adelaida	b	
adelan	t	adela
adelayda	b	
adelba	b	
adelfa	b	
adelfina	b	
adelgiza	b	
adeli	b	
adelia	b	
adelie	b	
adelif	b	
adelina	b	
adelinda	b	
adelita	b	
adeliza	b	
adelma	b	
adelmira	b	
adelmy	b	
adelvina	b	
adely	b	
ademis	b	
adenis	b	
adeodata	b	
aderlina	b	
adeyla	b	
adi	b	
adialgiza	b	
adiela	b	
adiera	b	
adiht	b	
adila	b	
adilia	b	
adilma	b	
adis	b	
adisnarda	b	
admira	b	
adolina	b	
adolinda	b	
adonay	b	
adonia	b	
adonima	b	
adora	b	
adoracion	b	
adoraly	b	
adorcinda	b	
adorecinda	b	
adoreina	b	
adorsinda	b	
adrea	t	andrea
adrian	b	
adriana	b	
adrina	b	
adritila	b	
adumerita	b	
aduviges	b	
ady	b	
adys	b	
aedilma	b	
aelina	b	
aeuclides	t	euclides
afelia	b	
afra	b	
ageda	b	
agedita	b	
agela	t	angela
agipina	t	agripina
aglae	b	
agnery	b	
agripina	b	
aguadita	b	
agudelia	b	
agueda	b	
aguedita	b	
aguera	t	agueda
aguida	b	
agustina	b	
agusttina	t	agustina
ahida	b	
ahide	b	
ahidec	b	
ahidee	b	
ahidy	b	
ahurora	b	
ahylet	b	
aichel	b	
aida	b	
aidali	b	
aidalia	b	
aidaly	b	
aide	b	
aided	b	
aidee	b	
aideth	b	
aidita	b	
ailen	b	
ain	b	
aira	b	
aired	b	
aireth	b	
airy	b	
aisa	b	
aiva	b	
aixa	b	
alaba	t	alba
alacia	b	
alaejandra	t	alejandra
alais	b	
alalgiza	b	
alba	b	
albaira	b	
albania	b	
albecia	b	
albeira	b	
albenia	b	
albenis	b	
albeniz	b	
alberta	b	
albertina	b	
albesa	b	
albiana	b	
albidina	b	
albilia	b	
albina	b	
albinia	b	
albirina	b	
albis	b	
albudina	b	
alby	b	
alcelmira	b	
alcida	b	
alcidia	b	
alcila	b	
alcira	b	
alcirella	b	
alcitra	t	alcira
alcy	b	
alda	b	
aldamari	b	
aldana	b	
aldara	b	
aldemary	b	
aldivna	b	
aldna	t	aldana
alegria	b	
aleida	b	
aleidy	b	
aleira	b	
aleja	b	
alejandina	b	
alejandra	b	
alejandria	b	
alejandrina	b	
alelia	b	
alenia	b	
alenxandra	t	alexandra
alex	b	
alexa	b	
alexan	b	
alexandra	b	
alexi	b	
alexia	b	
alexis	b	
alexsa	b	
aleyda	b	
aleyla	b	
alfa	b	
alfany	b	
alfha	b	
alfonsa	b	
alfonsina	b	
alfredina	b	
alfy	b	
alga	t	olga
algecira	b	
algemira	b	
ali	b	
alia	b	
alibia	b	
alice	b	
alicia	b	
alicias	b	
alicica	t	alicia
alicita	b	
alida	b	
alide	b	
alidia	b	
alied	b	
aliedt	b	
alier	b	
aliet	b	
alieth	b	
aliette	b	
alina	b	
alipia	b	
alique	b	
aliqui	b	
alira	b	
aliria	b	
aliris	b	
alis	b	
alisabeth	b	
alisenit	b	
alith	b	
alix	b	
alixi	b	
alixis	b	
aliyde	b	
alizabeth	b	
aljemira	b	
alli	b	
alliette	b	
alma	b	
almarosa	b	
almeida	b	
almeira	b	
almira	b	
almoraldina	b	
alngelmira	t	angelmira
alodia	b	
aloida	b	
aloise	b	
alpidia	b	
alpina	b	
alpipia	b	
alrley	t	arley
alselma	b	
alsy	b	
altagracia	b	
alu	b	
aluley	b	
alura	b	
alva	b	
alvanely	b	
alvarina	b	
alvenia	b	
alvestina	b	
alvia	b	
alvidiana	b	
alvidina	b	
alvina	b	
alvinia	b	
alvira	b	
alvirina	b	
alvis	b	
ama	t	ana
amada	b	
amady	b	
amagda	b	
amahuensy	b	
amaira	b	
amalfi	b	
amalia	b	
amamda	t	amanda
amanda	b	
amaparo	t	amparo
amapracedes	b	
amapro	t	amparo
amaria	t	maria
amatilde	t	anatilde
ambrosia	b	
amelfi	b	
amelia	b	
amelida	b	
amelina	b	
america	b	
amilbia	b	
amilde	b	
amilia	b	
amina	b	
aminda	b	
aminta	b	
amira	b	
amita	b	
amma	t	emma
amnada	t	amanda
amoris	b	
ampara	t	amparo
amparao	t	amparo
ampario	t	amparo
amparo	b	
amria	t	maria
amriela	t	mariela
amrina	t	marina
amrisol	t	marisol
amyriam	t	myriam
an	t	ana
ana	b	
anabeiba	b	
anabel	b	
anabell	b	
anabelsu	b	
anabelsut	b	
anabigail	b	
anaceli	b	
anacelia	b	
anacidia	b	
anacleofe	b	
anacleonte	b	
anacler	b	
anacleta	b	
anaclovis	b	
anadela	b	
anadelia	b	
anadelina	b	
anadelis	b	
anadelmira	b	
anadey	b	
anadid	b	
anadilde	b	
anadilia	b	
anadilza	b	
anaelia	b	
anafael	b	
anaflor	b	
anahir	b	
anahis	b	
anaibe	b	
anaid	b	
anaida	b	
anaide	b	
anailde	b	
anair	b	
anaires	b	
anais	b	
anaiss	t	anais
anait	b	
anaiz	b	
anajael	b	
analeida	b	
analeocinda	b	
analeth	b	
anali	b	
analia	b	
analida	b	
analita	b	
analith	b	
analiyer	b	
anan	b	
anani	b	
ananit	b	
anany	b	
anarcelia	b	
anarcinda	b	
anarvides	b	
anasael	b	
anasive	b	
anastacia	b	
anastasia	b	
anatael	b	
anatalia	b	
anatilde	b	
anatilia	b	
anatolia	b	
anatulia	b	
anauris	b	
anayansy	b	
anaydu	b	
anayibe	b	
anayme	b	
anayr	b	
anazael	b	
ancelma	b	
ancena	b	
andali	b	
andelina	b	
andelma	b	
andrea	b	
andriana	b	
andromeda	b	
ane	b	
aneida	b	
añeida	b	
aneidy	b	
anelis	b	
anesky	b	
anet	b	
aneth	b	
anetilde	b	
aneyda	b	
ang	b	
ange	b	
angedelina	b	
angela	b	
angele	b	
angelea	t	angela
angeles	b	
angeli	b	
angelica	b	
angelina	b	
angelita	b	
angelmira	b	
angeniz	b	
angie	b	
anglita	t	angelita
angostura	b	
angracia	b	
angrla	t	angela
angula	t	angela
angustia	b	
angustias	b	
angy	b	
anibel	b	
anicasia	b	
anicenia	b	
aniceta	b	
anidia	b	
anileina	b	
anilvia	b	
anin	b	
anincia	b	
anira	b	
anita	b	
aniusca	b	
anlly	b	
anlucy	b	
ann	b	
anna	b	
annia	b	
annie	b	
anny	b	
annya	b	
anonia	b	
anparo	t	amparo
anselma	b	
anselmina	b	
anserna	b	
anta	t	ana
antilde	t	anatilde
anto	t	antonia
antolina	b	
antomia	t	antonia
antonia	b	
antoniao	t	antonia
antonias	t	antonia
antonieta	b	
antoniia	t	antonia
antonina	b	
antronila	b	
antuca	b	
anuaria	b	
anumelia	b	
anunciacicn	t	anunciacion
anunciaciom	t	anunciacion
anunciacion	b	
anuniacion	t	anunciacion
anunila	t	nunila
anyela	b	
anyelid	b	
anyeline	b	
anyelyth	b	
anyerly	b	
anyi	b	
anyilid	b	
anyul	b	
aolga	t	olga
apolonia	b	
aquilea	b	
aquilina	b	
arabani	b	
arabella	b	
arabia	b	
arabil	b	
aracela	b	
araceli	b	
aracelia	b	
aracelina	b	
aracelis	b	
aracelly	b	
aracelu	t	aracely
aracely	b	
aracelys	b	
aracey	b	
aradelina	b	
araldid	b	
araminda	b	
araminta	b	
aramis	b	
aramita	b	
arareibe	b	
aratelvia	b	
aravella	b	
arbel	b	
arbelisa	b	
arbeliza	b	
arcadia	b	
arcelia	b	
arcelina	b	
arcenet	b	
arceneth	b	
arcenia	b	
arcesina	b	
arcilia	b	
arden	b	
are	b	
areida	b	
areidy	b	
areli	b	
arelia	b	
arelis	b	
arelix	b	
arelys	b	
arelyz	b	
argedilia	b	
argel	b	
argelia	b	
argelina	b	
argelis	b	
argemira	b	
argeni	b	
argenia	b	
argenides	b	
argenis	b	
argeniz	b	
argeriz	b	
arginiz	b	
aria	b	
arialda	b	
ariana	b	
aricela	b	
aried	b	
ariela	b	
arieta	b	
arihadna	b	
aris	b	
aristela	b	
aristelia	b	
aristella	b	
aristemia	b	
aristenia	b	
aristila	b	
aristobula	b	
aristrith	t	astrith
arjurith	b	
arlecy	t	arley
arledy	b	
arleidis	b	
arlenis	b	
arlet	b	
arleth	b	
arlett	t	arlet
arley	b	
arlinda	b	
arliria	t	aliria
arlix	b	
arliz	b	
armela	b	
armelinda	b	
armenia	b	
armida	b	
armide	b	
armilbia	b	
armilda	b	
armilina	b	
armina	b	
arminda	b	
arminta	b	
armira	b	
arnovia	b	
arseneth	b	
arsenia	b	
arta	t	martha
arveira	b	
arvelina	b	
arveliza	b	
ascencion	b	
asceneth	b	
ascension	b	
asdry	b	
asencion	b	
asened	b	
aseneth	b	
asenneth	b	
asly	b	
asmara	b	
astebia	b	
astela	t	estela
asteria	b	
astrid	b	
astrit	b	
astrith	b	
astry	b	
asturia	b	
asucena	b	
asuncion	b	
asunsion	t	asuncion
ataliva	b	
atanacia	b	
atanasia	b	
atenais	b	
atenay	b	
athala	b	
athelaska	b	
atilia	b	
auda	b	
audalia	b	
audalina	b	
audalinda	b	
audela	b	
audeli	b	
audelia	b	
audelina	b	
audelinda	b	
audely	b	
audi	b	
audicia	b	
audilia	b	
audolina	b	
audora	b	
audrey	b	
augenia	t	eugenia
augusta	b	
aunice	b	
auora	b	
aura	b	
auralicia	b	
auralina	b	
auraq	t	aura
aurea	b	
aureli	b	
aurelia	b	
aureliala	b	
aureliana	b	
aurelicia	b	
aurelina	b	
aurentina	b	
auris	b	
aurisbelia	b	
aurita	b	
auro	t	aurora
aurolina	b	
aurora	b	
aury	b	
austriberta	b	
autonia	t	antonia
auxilia	b	
auxiliadora	b	
auxilio	b	
avangelina	t	evangelina
avelia	b	
avelina	b	
aven	b	
avicena	b	
avigail	b	
axucena	b	
ayarif	b	
ayda	b	
aydali	b	
ayde	b	
aydee	b	
ayden	b	
aydi	b	
ayibe	b	
ayllene	b	
aymett	b	
aztarde	b	
azucena	b	
azucenza	t	azucena
azulehime	b	
azusena	t	azucena
babina	b	
baby	b	
bacilia	b	
baetriz	t	beatriz
baira	b	
balanca	t	blanca
balba	t	alba
balbina	b	
balcelina	b	
balcimina	b	
balentina	t	valentina
balmira	b	
balnca	t	blanca
balois	b	
balquidia	b	
balsamina	b	
balsamira	b	
balsemina	b	
balvina	b	
banca	t	blanca
banilda	b	
barabara	t	barbara
barb	t	barbara
barbara	b	
barbarita	b	
barbra	b	
bardot	b	
barena	b	
barlebis	b	
basilia	b	
baslit	b	
batriz	t	beatriz
baudelina	b	
baudilia	b	
beatiz	t	beatriz
beatreiz	t	beatriz
beatris	t	beatriz
beatriz	b	
beatrz	t	beatriz
beda	b	
bedsabe	b	
begonia	b	
behiva	t	beiva
beiba	b	
beici	b	
beil	b	
beira	b	
beisi	b	
beiva	b	
bel	b	
belan	b	
belardina	b	
belarmina	b	
belba	b	
belcey	b	
belcy	b	
belda	b	
beldi	b	
beldy	b	
belen	b	
belfa	b	
belia	b	
belinda	b	
belisa	b	
belkis	b	
belky	b	
belkys	b	
belkyz	b	
bell	b	
bella	b	
belladul	b	
bellaflor	b	
bellaldina	b	
bellamira	b	
bellamire	b	
bellanid	b	
bellanida	b	
bellanides	b	
bellanidt	b	
bellanila	b	
bellanira	b	
bellanire	b	
bellanit	b	
bellanith	b	
bellanyth	b	
bellardina	b	
bellarmina	b	
bellaul	b	
bellavel	b	
belma	b	
belmira	b	
beloen	t	belen
belqui	b	
belquir	b	
belquis	b	
belsa	b	
belsamina	b	
belsay	b	
belsi	b	
belsis	b	
belssy	t	belsy
belsu	b	
belsud	b	
belsut	b	
belsy	b	
beltzy	b	
belva	b	
bely	t	nely
belzabeth	b	
belzu	b	
benacir	b	
benancia	b	
benardina	t	bernardina
benda	t	brenda
beneda	b	
benedice	b	
benedicta	b	
benelsa	b	
benicia	b	
benigna	b	
benilda	b	
benilde	b	
benita	b	
benjamina	b	
bentura	t	ventura
benulda	t	benilda
bercelia	b	
bercelina	b	
bercely	b	
bercelyn	b	
bercelys	b	
bercy	b	
beremy	b	
berena	b	
berenely	b	
berenica	t	berenice
berenice	b	
berenicie	t	berenice
berenilce	b	
berenise	b	
berenith	b	
berenize	b	
berha	t	bertha
berhta	t	bertha
beridionor	b	
berlamina	t	belarmina
berlarmina	b	
berly	b	
bernabet	b	
bernanda	b	
bernanrda	t	bernarda
bernanrdina	t	bernardina
bernarda	b	
bernardian	t	bernardina
bernardina	b	
bernardita	b	
bernave	b	
bernis	b	
beronica	b	
bersa	b	
bersabe	b	
bersabet	b	
bersabeth	b	
bersaida	b	
bersali	b	
bersaly	b	
bersatbe	b	
bersi	b	
berta	b	
bertalina	b	
bertha	b	
berthi	b	
bertide	b	
bertilda	b	
bertilde	b	
bertilta	t	bertilda
bertilvia	b	
bertina	b	
bertoldina	b	
bertsabe	b	
bertsabeth	b	
bertulia	b	
berzabe	b	
berzabet	b	
berzabeth	b	
besabet	t	bersabet
beterlicia	b	
bethi	b	
bethsabe	b	
bethsy	b	
bethusa	b	
bethy	b	
beti	b	
betilde	b	
betolia	b	
betriz	t	beatriz
betsa	b	
betsabe	b	
betsabet	b	
betsabeth	b	
betsabi	b	
betssy	b	
betsy	b	
betti	b	
bettina	b	
bettsy	b	
betty	b	
betulia	b	
bety	b	
betys	b	
betza	b	
betzabe	t	betsabe
bey	b	
beya	b	
beyanet	b	
beyanira	b	
beyba	b	
bianery	b	
bianey	b	
biatila	b	
bibiana	b	
bicena	b	
bilma	b	
biomida	b	
bisbita	b	
bitalina	b	
bitelbina	b	
bitelvina	b	
biterlicia	b	
bivia	b	
biviana	b	
biyely	b	
blaca	t	blanca
blacina	b	
blacinda	b	
blair	b	
blana	t	blanca
blanaca	t	blanca
blanca	b	
blanche	b	
blandia	b	
blandina	b	
blanjca	t	blanca
blascelina	b	
blashina	b	
blasina	b	
blasinia	b	
blaudina	b	
bleidis	b	
blekis	t	belkis
blellen	b	
bleyde	b	
bleydy	b	
blides	b	
blnac	t	blanca
blnca	t	blanca
blodys	b	
bodomera	b	
bolivia	b	
bonifacia	b	
bonita	b	
bonnie	b	
bony	b	
bqrbara	t	barbara
branny	b	
braulia	b	
braulica	b	
bravia	b	
bremilda	b	
brenda	b	
briccida	b	
briceida	b	
bricel	b	
bricela	b	
bricelda	b	
briceldina	b	
bricelia	b	
bricelina	b	
bricilda	t	bricelda
brigete	b	
brigida	b	
brigidia	t	brigida
brigille	b	
brigit	b	
brigite	b	
brigith	b	
brigithe	b	
brigitte	b	
brigyith	b	
brijida	b	
bril	t	abril
brisa	b	
brisalba	b	
brisalda	b	
brisalva	b	
brisdelinda	b	
briseida	b	
briselia	b	
brisol	b	
brissa	b	
brita	b	
britte	b	
brivit	t	brigit
brixeida	b	
briyeidy	b	
briyi	b	
briyid	b	
briyith	b	
briza	b	
bromer	b	
bronia	b	
bruna	b	
brunequilde	b	
brunilda	b	
brunilde	b	
bruniquilda	t	brunequilde
buterfley	b	
caatalina	t	catalina
cacilda	b	
calixta	b	
caludia	t	claudia
camelia	b	
camen	t	carmen
camila	b	
campoelina	b	
candeda	t	candida
candela	b	
candelaria	b	
candida	b	
cantalicia	b	
caonsejo	t	consejo
caqrmen	t	carmen
caren	b	
carime	b	
carina	b	
carla	b	
carleli	b	
carlely	b	
carlina	b	
carlota	b	
carman	t	carmen
carme	t	carmen
carmela	b	
carmelia	b	
carmelina	b	
carmelita	b	
carmem	t	carmen
carmen	b	
carmenb	t	carmen
carmenbza	t	carmenza
carmenla	t	carmela
carmensa	b	
carmenza	b	
carmina	b	
carmiña	b	
carmne	t	carmen
carmnen	t	carmen
carmnza	t	carmenza
carmon	b	
caro	b	
caroj	t	caro
carol	b	
carola	b	
carolin	b	
carolina	b	
caroline	b	
caroo	t	caro
carra	t	carla
cary	t	dary
casilda	b	
casimira	b	
castula	b	
catalina	b	
catarina	b	
catherin	b	
catherine	b	
catina	b	
cayetana	b	
cebelinda	b	
ceccilia	t	cecilia
ceceilia	t	cecilia
cecelia	t	cecilia
ceciclia	t	cecilia
ceciilia	t	cecilia
cecil	b	
cecila	t	cecilia
cecili	t	cecilia
cecilia	b	
cecillia	t	cecilia
cecilua	t	cecilia
ceclia	t	cecilia
cedelina	b	
cedolia	b	
ceecilia	t	cecilia
ceferina	b	
cefora	b	
ceida	b	
ceila	b	
ceilia	t	ceila
ceira	b	
celandra	b	
celcilia	t	cecilia
celdana	b	
celedonia	b	
celena	b	
celene	b	
celenia	b	
celeny	b	
celeste	b	
celestina	b	
celfia	b	
celi	b	
celia	b	
celicia	b	
celida	b	
celie	b	
celila	b	
celilia	b	
celima	b	
celina	b	
celinda	b	
celinia	b	
celma	b	
celmira	b	
celmyra	b	
celotilde	t	cleotilde
celsa	b	
cemada	b	
cenaida	b	
cenaira	b	
ceneida	b	
ceneira	b	
cenelia	b	
cenely	b	
cenet	b	
ceneth	b	
cenil	b	
cenis	b	
cenit	b	
cenith	b	
cenobia	b	
cenovia	b	
cension	b	
ceny	b	
cerafina	b	
cerbeleon	b	
cerelda	b	
cerla	b	
cerlina	b	
cerlinda	b	
cermelina	t	carmelina
cermen	t	carmen
cervelina	b	
cervilia	b	
cesarea	b	
cesaria	b	
cevelinda	b	
ceyi	b	
ceyla	b	
charita	b	
charo	b	
chavela	b	
chavely	b	
chela	b	
chened	b	
cherly	b	
chiguira	b	
chiquinquira	b	
christian	b	
christiane	b	
christie	b	
christina	b	
chuiquinquira	t	chiquinquira
cibilina	b	
cidalia	b	
cidelia	b	
cidia	b	
cidilia	b	
ciela	t	cielo
cielo	b	
cilda	b	
cildana	b	
cilena	b	
cilene	b	
cilenia	b	
cilia	b	
cincy	b	
cindy	b	
cinforosa	b	
cinthia	b	
ciplicio	b	
cipriana	b	
cira	b	
circuncicion	b	
circuncision	b	
circunsicion	b	
ciria	b	
ciris	b	
cirle	b	
cirley	b	
cirsitina	t	cristina
cita	t	rita
civelina	b	
civilina	b	
claiden	b	
claika	b	
claire	b	
clamencia	t	clemencia
clara	b	
clared	b	
claredth	b	
clarena	b	
clarencia	b	
clarenza	b	
claret	b	
clareth	b	
claribel	b	
claribet	b	
claribeth	b	
claridel	b	
clarion	b	
clarisa	b	
clarita	b	
clarivel	b	
clariveth	b	
clarixa	b	
clariza	b	
claude	b	
claudelina	b	
claudi	b	
claudia	b	
claudina	b	
claudine	b	
claudua	t	claudia
claudy	b	
claver	b	
clayree	b	
clecia	b	
cledia	b	
cledys	b	
cleida	b	
cleila	b	
cleire	b	
clelia	b	
clemancia	t	clemencia
clememcia	t	clemencia
clemencia	b	
clementina	b	
clemetina	b	
cleo	b	
cleofa	b	
cleofe	b	
cleofed	b	
cleofelina	b	
cleofilina	b	
cleogesina	b	
cleopatra	b	
cleope	b	
cleotilda	b	
cleotilde	b	
cleova	b	
cleovis	b	
cleria	b	
clerida	b	
clery	b	
cleta	b	
cleyla	b	
clicinia	b	
cliotilde	b	
cllemencia	t	clemencia
clobelia	b	
clobis	b	
clobys	b	
clodis	b	
clodocinda	b	
clodomira	b	
clodya	b	
clondis	b	
cloria	t	gloria
closinda	b	
closvinda	b	
clotilde	b	
clovelia	b	
clovis	b	
clrivel	t	clarivel
cluadia	t	claudia
cludia	t	claudia
clvis	t	clovis
concebida	b	
concejo	b	
concenpcion	t	concepcion
conceocion	t	concepcion
concepcion	b	
concepecion	t	concepcion
conchita	b	
concia	b	
concilio	b	
concpecion	t	concepcion
concuelo	t	consuelo
conepcion	t	concepcion
consejo	b	
consepcion	t	concepcion
consilio	b	
consolacion	b	
consstanza	t	constanza
constancia	b	
constansa	b	
constant	t	constanza
constantina	b	
constanza	b	
consuelo	b	
consuleo	t	consuelo
cony	b	
conzuelo	b	
copelia	b	
cora	b	
coral	b	
corazo	t	corazon
corazon	b	
cordia	b	
corina	b	
corlina	b	
cornelia	b	
coromoto	b	
corona	b	
costanza	t	constanza
crecencia	b	
crecenciana	b	
crelia	b	
creotilde	b	
crescencia	b	
cresencia	b	
cresenciana	b	
cricel	b	
cricilia	b	
crimelda	b	
crimilde	b	
cris	b	
crisalia	b	
crisanta	b	
crisbelly	b	
criselda	b	
criselia	b	
crisilda	b	
crisilia	b	
crismelda	b	
crisnely	b	
crispina	b	
crispiniana	b	
crispula	b	
cristal	b	
cristencen	b	
cristi	b	
cristiana	b	
cristina	b	
cristna	t	cristina
cristobalina	b	
cristrina	t	cristina
critina	t	cristina
crmen	t	carmen
crstina	t	cristina
crucelia	b	
cruselina	b	
cuastodia	t	custodia
curubina	b	
custodia	b	
custosia	t	custodia
dabeiba	b	
dabeida	b	
dabeise	b	
dacier	b	
dadel	b	
dadley	t	darley
dadni	b	
daibet	b	
dail	b	
daile	b	
daina	b	
daira	b	
daissi	b	
daissy	b	
daisy	b	
daizzy	b	
dalgie	b	
dalia	b	
dalida	b	
dalila	b	
dalina	b	
dalis	b	
dallana	b	
dalma	b	
daly	b	
dalys	b	
dama	b	
damacia	b	
damal	b	
damarcena	b	
damari	b	
damaris	b	
damary	b	
damarys	b	
damely	b	
damiana	b	
damira	b	
dana	b	
dancy	b	
danel	b	
danelly	b	
danely	b	
daneris	b	
daneyi	b	
dangela	t	angela
dani	b	
dania	b	
daniela	b	
daniely	b	
danila	b	
daniloba	b	
danira	b	
danis	b	
danit	b	
danitza	b	
daniza	b	
danny	b	
daraminta	b	
darcy	b	
darcyn	b	
dargel	b	
dari	t	dary
daria	b	
darien	b	
darkis	b	
darky	b	
darkys	b	
darlany	b	
darley	b	
darlin	b	
darly	b	
darmlse	b	
darnely	b	
dary	b	
darys	b	
dassy	t	daisy
daveiva	b	
davidica	b	
davinia	b	
daxi	b	
dayana	b	
dayane	b	
dayanna	b	
dayci	b	
dayitha	b	
dayly	b	
dayne	b	
dayra	b	
daysee	b	
daysi	b	
daysy	b	
dayzuly	b	
ddel	t	del
dealile	t	dalila
deatriz	t	beatriz
debora	b	
debra	b	
deby	b	
deccy	b	
decida	b	
decinelda	b	
dedt	b	
dedulfa	b	
deel	t	del
degna	b	
dehisy	b	
deiby	b	
deici	b	
deicy	b	
deidania	b	
deidy	b	
deifa	b	
deifilia	b	
deigracia	b	
deigy	b	
deilan	b	
deira	b	
deiry	b	
deise	t	deisy
deisi	b	
deisse	b	
deissy	b	
deisy	b	
del	b	
delaida	b	
delba	b	
delby	b	
delci	b	
delcia	b	
delcira	b	
delcy	b	
delfa	b	
delfenia	b	
delfilia	b	
delfina	b	
deli	b	
delia	b	
delicia	b	
delicias	b	
delida	b	
delides	b	
delina	b	
delires	b	
delis	b	
delisa	b	
dell	t	del
dellanira	b	
dellanit	b	
delly	b	
dellys	b	
delma	b	
delmira	b	
delmy	b	
delsa	b	
delsi	b	
delsin	b	
delsis	b	
delsy	b	
deluvina	b	
delva	b	
delvia	b	
delvina	b	
delvy	b	
dely	b	
delys	b	
demanele	b	
demetria	b	
denci	b	
dency	b	
denesse	b	
deniis	b	
denires	b	
denis	b	
denise	b	
deniz	t	denis
dennise	b	
dennisse	b	
denny	b	
dennys	b	
deny	b	
denys	b	
deogracia	b	
deonila	b	
derby	b	
dercy	b	
derfilia	b	
derisana	b	
derli	b	
derlin	b	
derlinda	b	
derly	b	
derlyth	b	
dersi	b	
dersy	b	
dery	b	
desidelia	b	
desideria	b	
desposorio	b	
dessy	b	
develsi	b	
devora	t	debora
dexi	b	
dexis	b	
dexy	b	
dey	b	
deyanira	b	
deyanith	b	
deyasira	t	deyanira
deyasmin	b	
deybi	b	
deyby	b	
deyce	b	
deyci	b	
deycy	b	
deydanila	b	
deydi	b	
deydy	b	
deyfra	b	
deyis	b	
deyla	b	
deymaimare	b	
deynis	t	denys
deyse	b	
deysi	b	
deyssi	b	
deysy	b	
dfary	t	dary
dfel	t	del
di	b	
diadema	b	
dialile	b	
dialis	b	
dialy	b	
dialyd	b	
diamely	b	
diamile	b	
diamira	b	
diana	b	
dianan	t	diana
diane	b	
dianelly	b	
dianeth	b	
dianey	b	
dianid	b	
dianile	b	
dianily	b	
dianira	b	
dianith	b	
dianna	t	diana
dianuth	b	
diasmin	b	
diasmina	b	
dibe	b	
dibeth	b	
dicely	b	
didia	b	
didiana	t	bibiana
didilia	b	
diela	b	
digllia	t	dilia
dignacely	b	
dignali	b	
dignora	b	
dila	b	
dilba	b	
dilce	b	
dilcia	b	
dilcy	b	
dilde	b	
dilfa	b	
dili	t	dilia
dilia	b	
diliam	b	
diliana	b	
dilma	b	
dilneyra	b	
dilola	b	
dilsa	b	
dilsia	t	dilsa
diluvina	b	
dilvania	b	
dilvia	b	
dilya	b	
dimelsa	b	
dimey	b	
dimicia	b	
dimira	b	
dimuried	b	
dina	b	
dinacela	b	
dinaluz	b	
dinelly	b	
dinet	b	
diney	b	
dineyi	b	
dinger	b	
dinna	b	
dinora	b	
dinoris	b	
diocelin	b	
diocelina	b	
diocely	b	
diocitea	b	
diodata	b	
diodelina	t	dioselina
diodila	b	
diofelina	b	
diofila	b	
diolaida	b	
diolima	b	
dioly	b	
diomar	b	
diomara	b	
diomary	b	
diomarys	b	
diomayra	b	
diomedis	b	
diomeira	t	diomira
diomelina	b	
diomigilda	b	
diomina	b	
diomira	b	
diomisia	b	
diomitila	t	domitila
dione	b	
dioneira	b	
dioneyda	b	
dioni	t	dione
dionicia	t	dionisia
dionilda	b	
dionilde	b	
dionis	b	
dionisia	b	
dionisis	b	
dionny	b	
dionor	b	
dionys	b	
diorgelina	b	
diosa	b	
diosabel	b	
diosalia	b	
diosana	b	
dioscelina	b	
dioseli	b	
dioselin	b	
dioselina	b	
diosilde	b	
diosilia	b	
diosinda	b	
diosmira	b	
diostely	b	
diotelinda	b	
diotista	b	
diovigilda	b	
dioza	t	diosa
dirce	b	
diria	b	
dirima	b	
diris	b	
dirley	b	
dirma	b	
diseney	b	
disinelda	b	
disnarda	b	
disney	b	
disneysi	b	
disoselina	b	
disoteo	b	
diumeliana	b	
diuzmaida	b	
diva	b	
divas	t	diva
divenely	b	
diveth	b	
divia	b	
divina	b	
divinelly	b	
divineyi	b	
dixi	b	
diznarda	b	
dl	t	del
dle	t	del
docitea	b	
doe	b	
dofila	b	
dolfendy	b	
dolfenia	b	
dolfina	b	
doli	b	
dolid	b	
dolila	t	dalila
dolis	b	
doliz	t	dolis
dolli	b	
dolly	b	
dolma	b	
dolores	b	
dolorez	t	dolores
dolres	t	dolores
doly	b	
dolyasmina	b	
domicia	b	
domiciana	b	
domicila	b	
domicilia	b	
dominga	b	
dominia	b	
domitila	b	
domitilia	t	domitila
domma	b	
dona	b	
donaida	b	
donaira	b	
donalila	b	
donata	b	
donatila	b	
donatina	b	
donelia	b	
doney	b	
donila	t	danila
doninabeth	b	
donis	b	
dony	b	
dora	b	
doraida	b	
doralb	t	doralba
doralba	b	
doralbba	t	doralba
dorales	b	
dorali	b	
doralia	b	
doralice	b	
doralid	b	
doralina	b	
doralinda	b	
doralis	b	
doraliz	b	
doralva	b	
doraly	b	
doralys	b	
dorana	b	
dorance	b	
doranced	b	
doranny	b	
dorany	b	
doranyi	b	
dorcas	b	
dorcina	t	dorcinda
dorcinda	b	
dordy	b	
dorelcy	b	
doreli	b	
dorelis	b	
dorelli	t	dorelly
dorelly	b	
dorely	b	
dori	b	
doria	b	
dorian	b	
dorie	b	
dorila	b	
dorilia	b	
doris	b	
dorisana	b	
dorisnelda	b	
dorita	b	
doritza	b	
dorizana	b	
dorlany	b	
dorli	t	dorly
dorly	b	
dormelina	b	
dorotea	b	
dorsamilla	b	
dorsinda	b	
dory	b	
dorys	b	
dositea	b	
dovelia	b	
dovile	b	
driana	b	
drigelia	b	
drucila	b	
dubiela	b	
duby	t	ruby
duila	b	
duilyan	b	
duioneth	b	
dulcelina	b	
dulcey	b	
duley	b	
dulfay	b	
dulia	b	
dulian	b	
dulina	b	
dullys	b	
duluvina	b	
dulys	b	
dunia	b	
duperly	b	
durame	b	
durcey	b	
durene	b	
duris	t	doris
durlaez	b	
durlains	b	
durley	b	
dury	b	
duviela	b	
duvina	b	
dyana	t	diana
dylia	b	
dylsa	b	
dyone	b	
dyvi	b	
eala	b	
ealeen	t	eileen
ebarced	b	
ebelia	b	
ebelina	b	
ebeth	t	ibeth
ebiladia	b	
ebseria	b	
eccelina	b	
ecilda	b	
ecilenia	b	
ecilia	t	cecilia
ecolastica	b	
eda	b	
edala	b	
edaley	b	
edali	b	
edalia	b	
edda	b	
eddi	b	
eddie	b	
eddy	b	
eddyth	b	
edeida	b	
edeilmira	t	edelmira
edel	b	
edelfa	b	
edelia	b	
edelina	b	
edelira	b	
edelith	b	
edelma	b	
edelmina	b	
edelmira	b	
edelsa	t	edilsa
edemira	t	edelmira
ederminda	b	
edey	b	
edhith	t	edith
edi	b	
edialia	t	edilia
edianira	b	
edicta	b	
edid	b	
edidth	t	edith
edila	t	edilia
edilama	t	edilma
edilberta	b	
edilce	b	
edilcia	b	
edilen	b	
edilfa	b	
edilfonsa	b	
edili	t	edilia
edilia	b	
edilma	b	
edilme	t	edilma
edilmira	t	edelmira
edilsa	b	
edilse	b	
edilta	t	edita
edilvia	b	
edilza	b	
edimenia	b	
ediofina	b	
edioselina	t	dioselina
edipsa	t	edilsa
edir	b	
edira	b	
ediramar	b	
edis	b	
edit	t	edith
edita	b	
editd	t	edith
edith	b	
edly	b	
edmee	b	
edna	b	
ednaida	b	
edorita	t	dorita
edthi	t	edith
edtna	t	edna
eduarda	b	
edubiges	t	eduviges
edubijes	t	eduviges
edubina	b	
edulibia	b	
edulveira	b	
edunina	b	
edurne	b	
edurnes	b	
eduviges	b	
eduvigis	t	eduviges
eduvijes	t	eduviges
eduvina	b	
edy	b	
edyd	b	
edys	b	
edyth	b	
eernetina	t	ernestina
efegenia	t	efigenia
efidia	b	
efigenia	b	
efiguenia	t	efigenia
efiliana	b	
efitania	b	
efrosina	b	
egda	b	
egidia	b	
egla	b	
eglantine	b	
egledy	b	
egleth	b	
eglis	b	
ehida	b	
eibi	b	
eida	t	aida
eiddy	b	
eidelma	t	edilma
eidi	b	
eidy	b	
eileen	b	
eira	t	neira
eisolina	t	isolina
elaba	t	elba
elada	b	
eladia	b	
eladys	t	ledys
elaine	b	
elana	b	
elaudice	b	
elba	b	
elbecia	b	
elbia	t	elvia
elbina	b	
elci	b	
elcia	b	
elcida	b	
elcidia	b	
elcira	b	
elcy	b	
elcyda	b	
elda	b	
eldelmira	t	edelmira
eldery	b	
eldina	b	
eldis	b	
eleana	t	eliana
elebi	b	
elecia	b	
electricia	b	
eledia	b	
eleida	b	
elelia	t	lelia
elena	b	
elene	t	elena
elenia	t	elena
elenice	b	
elenys	b	
eleodora	b	
eleoima	t	eloima
eleonora	b	
eleticia	t	leticia
eleuteria	b	
elexandra	t	alexandra
elexi	t	alexi
elfa	b	
elfilia	b	
elga	b	
elgi	b	
eliabeth	t	elizabeth
eliali	b	
eliana	b	
elianey	b	
eliano	t	eliana
eliany	b	
elibeth	b	
elica	t	erica
elicea	b	
elicena	b	
elicenia	b	
eliceria	t	elicenia
elicia	b	
eliciana	b	
elicida	b	
elicinda	b	
elida	b	
elidi	t	elidia
elidia	b	
elidina	b	
eliecea	b	
elifonsa	b	
eligia	b	
elima	t	elina
elina	b	
elinda	b	
eliney	b	
elins	b	
eliodora	b	
elionsa	b	
eliosa	t	eloisa
elis	b	
elisa	b	
elisabet	b	
elisabeth	b	
elisenia	b	
elisenith	b	
eliseria	b	
eliseth	b	
elisia	t	elisa
elisinda	b	
elisinde	t	elisinda
elisinia	t	elisenia
elita	b	
elith	t	edith
elivelia	b	
elivey	b	
eliyer	b	
eliza	b	
elizabeh	t	elizabeth
elizabeht	t	elizabeth
elizabelt	t	elizabeth
elizabelth	t	elizabeth
elizabet	b	
elizabeth	b	
elizabth	t	elizabeth
elizaneth	t	elizabeth
elizeth	t	lizeth
elja	b	
elly	b	
elma	b	
elmina	b	
elmira	b	
elñy	t	elcy
elodia	b	
eloida	b	
eloidina	b	
eloila	b	
eloima	b	
eloina	b	
eloisa	b	
eloiza	b	
eloydina	b	
elpidia	b	
elsa	b	
elsi	b	
elsia	t	elsa
elsida	b	
elside	b	
elsidia	b	
elsie	b	
elsin	b	
elssi	b	
elssy	b	
elsy	b	
eluciana	b	
eluinia	b	
eluvina	b	
elva	b	
elvania	b	
elvecia	b	
elvecina	b	
elvelcina	t	elvecina
elverena	b	
elvia	b	
elviatida	t	elviatila
elviatila	b	
elvicia	b	
elvidina	b	
elvina	b	
elvinaia	t	elvinia
elvinia	b	
elvir	b	
elvira	b	
elvirina	b	
elzbeth	t	elizabeth
ema	b	
emecelia	b	
emeira	b	
emelda	b	
emelia	b	
emelias	b	
emelina	b	
emelinda	b	
emelyna	b	
emeraida	b	
emeredith	b	
emeria	b	
emerida	b	
emeris	b	
emerita	b	
emerith	b	
emery	t	mery
emeteria	b	
emigdia	b	
emilce	b	
emilcen	b	
emilda	b	
emileidy	t	mileidy
emilena	t	milena
emilgen	b	
emilia	b	
emilian	t	emilia
emiliana	b	
emiliani	b	
emilina	b	
emilse	b	
emilsen	b	
emilta	b	
emir	b	
emira	b	
emirce	b	
emiria	t	emira
emirida	b	
emith	b	
emiyer	b	
emlia	t	emilia
emma	b	
emmma	t	emma
emmna	t	emma
emni	b	
empera	b	
emperatris	t	emperatriz
emperatriz	b	
emperetriz	t	emperatriz
emperita	b	
empidia	b	
empinia	t	empidia
empiria	t	empidia
emylce	b	
emylcer	b	
ena	t	ana
enaida	b	
encarnacion	b	
ened	b	
enedieth	b	
enedina	b	
enedy	b	
eneida	b	
enelda	b	
eneldis	b	
enelia	b	
enelias	t	enelia
enelsa	b	
enereida	t	nereida
eneri	b	
enerieth	b	
eneris	b	
enerita	t	emerita
enevelia	b	
eneyda	b	
engracia	b	
engri	t	ingri
enid	b	
enidia	b	
enilcia	b	
enilda	b	
enira	t	emira
enirida	b	
enis	t	ines
enit	b	
enith	b	
enix	b	
enixe	b	
enma	t	emma
enna	t	edna
enny	b	
enoc	b	
enock	b	
enoe	t	noe
enok	b	
enola	b	
enperatris	t	emperatriz
enriqueta	b	
enrriqueta	t	enriqueta
ensueño	b	
eny	b	
enyth	b	
eoilma	t	edilma
eonice	t	eunice
epifania	b	
epimenia	b	
epinemia	t	epimenia
epiritu	b	
ercelia	b	
ercilda	b	
ercilia	b	
ercinda	b	
erdulfa	b	
erecinda	t	ercinda
ereminta	b	
eremith	b	
erene	t	irene
erenia	b	
erenilda	b	
eresinda	b	
erfilia	t	orfilia
erialet	b	
erica	b	
ericilda	t	ercilda
ericinda	b	
eridia	b	
erika	b	
erikad	t	erika
erisade	b	
erisinda	b	
erlency	b	
erlendy	b	
erleny	b	
erli	b	
erlide	b	
erlina	b	
erlinda	b	
erly	b	
ermancia	b	
ermecinda	b	
ermelina	b	
ermelinda	b	
ermencia	b	
ermenza	b	
ermerenciana	b	
ermida	b	
ermila	b	
ermilda	b	
ermina	b	
erminda	b	
erminia	b	
ermis	b	
ermita	b	
ernedis	b	
ernenstina	t	ernestina
ernest	t	ernestina
ernestina	b	
ersilia	b	
erubidis	b	
esa	t	elsa
esabel	t	isabel
esbelicia	b	
escelina	b	
escilda	b	
esclavacion	b	
esclavasion	t	esclavacion
escolastica	b	
eselda	b	
eselmica	b	
esencion	t	ascencion
esilda	b	
esledy	b	
esleidy	b	
esleny	b	
eslibia	b	
eslinda	b	
esly	b	
esmeda	t	esneda
esmeida	b	
esmeira	b	
esmeli	b	
esmerald	b	
esmeralda	b	
esmerecilda	b	
esmila	b	
esmilda	b	
esminda	b	
esminia	b	
esmira	b	
esmirna	b	
esmit	b	
esmith	b	
esmitt	b	
esneda	b	
esnedy	b	
esneida	b	
esneidy	b	
esnelly	b	
esnely	b	
esneyder	b	
esneyer	b	
esneyre	b	
esnid	b	
esnilda	b	
españa	b	
esperaanza	t	esperanza
esperana	t	esperanza
esperansa	t	esperanza
esperanz	t	esperanza
esperanza	b	
espernza	t	esperanza
espidia	b	
espifania	t	epifania
espimenia	b	
espiritud	b	
esposorio	b	
esposotio	t	esposorio
estala	t	estela
estefania	b	
esteher	t	esther
estehr	t	esther
estela	b	
estelfa	t	estela
estelinda	b	
estella	b	
estelvina	b	
ester	b	
estervina	b	
estevia	b	
esthela	b	
esthella	b	
esther	b	
esthera	t	esthela
esthere	t	esther
esthter	t	esther
estraminda	b	
estreella	t	estrella
estrela	t	estrella
estrella	b	
estrellas	t	estrella
estrid	t	astrid
estuar	b	
etalvina	t	etelvina
etdaly	b	
etel	b	
etelbina	b	
etelinda	t	etelvina
etelma	b	
etelvia	b	
etelvina	b	
eterlinda	b	
ethel	b	
ethna	b	
etna	b	
etrella	t	estrella
eucaris	b	
euciris	b	
euclides	b	
eudalia	b	
eudasia	b	
eude	b	
eudelia	b	
eudes	b	
eudice	b	
eudith	t	edith
eudocia	b	
eudocta	t	eudocia
eudolina	b	
eudora	b	
eudoria	t	eudora
eudosia	b	
eudovina	b	
eudoxia	b	
eudy	b	
eufelmina	b	
eufemia	b	
eufenia	b	
eufimia	b	
eufogia	b	
eufracia	b	
eufrasia	b	
eufrocina	b	
eufrosina	b	
eugenai	t	eugenia
eugenia	b	
eugeniia	t	eugenia
eugenio	t	eugenia
eujenia	t	eugenia
eulacia	b	
euladis	b	
eulalia	b	
eulanid	t	eulalia
eulise	b	
eulodys	b	
eulogia	b	
eumelia	b	
eumelina	t	ermelina
eumilia	t	emilia
eunice	b	
eunife	b	
eunise	b	
eurania	b	
eurides	b	
eurora	t	aurora
eusebia	b	
eustacia	b	
eustaquia	b	
eustavia	b	
eustorgia	b	
eutenia	b	
eutequiana	b	
eutimia	b	
eutiquia	b	
eutiquiana	b	
eutiquio	b	
eutugio	t	eutiquio
eva	b	
evadilia	b	
evaglina	t	evangelina
evangelina	b	
evania	b	
evarista	b	
evastelia	b	
eve	b	
evedita	t	evita
evelia	b	
evelin	b	
evelina	b	
evelinda	b	
eveline	t	evelina
evely	b	
evelyn	b	
evencia	b	
evengalina	t	evangelina
evengelina	t	evangelina
everis	b	
everlides	b	
everni	b	
evernis	b	
everyn	t	evelyn
evidalia	b	
evidania	b	
evidelia	b	
evidelina	b	
evila	b	
evir	b	
evirleny	b	
evita	b	
evitalina	b	
evy	b	
exady	b	
excelina	b	
excenex	b	
excilenia	b	
exclamacion	b	
exclavacion	b	
exelina	b	
exemy	b	
exilda	b	
exomina	b	
eyalile	t	yalile
eyanira	t	yanira
eyde	b	
eyder	b	
eydie	b	
eydy	b	
eyla	b	
eynurian	b	
eyse	t	eysy
eysy	b	
eyzenia	t	yezenia
ezequiela	b	
fabiana	b	
fabiloa	t	fabiola
fabiola	b	
factorina	b	
facunda	b	
fadia	b	
fadiry	b	
fadua	b	
fady	b	
fael	b	
faelita	b	
faen	b	
faima	b	
faina	b	
fainory	b	
falconedia	b	
falconery	b	
fali	t	ali
famelia	t	amelia
fammy	t	fanny
fancy	b	
faned	b	
fanery	b	
faney	t	fany
fani	b	
fanne	t	fanny
fanny	b	
fanory	b	
fany	b	
farah	b	
fardelina	b	
fardeline	b	
farid	b	
faride	b	
farides	b	
faridy	b	
farieta	t	arieta
farina	b	
farit	t	farid
farith	b	
farley	b	
fatima	b	
fausta	b	
faustina	b	
faviola	t	fabiola
fecunda	b	
federica	b	
fedra	b	
feiza	b	
feli	b	
felia	b	
felicia	b	
feliciana	b	
felicidad	b	
felicinda	b	
felicita	b	
felicitas	t	felicita
felida	b	
felima	t	celina
felina	t	celina
felipa	b	
felisa	b	
felisita	b	
feliza	b	
felsomina	b	
feney	b	
fenider	b	
fenis	b	
fenita	b	
fenny	t	fanny
ferlinda	b	
fermaina	b	
fermina	b	
ferminda	b	
fernanada	t	fernanda
fernanda	b	
fernande	b	
fever	b	
fflor	t	flor
fidela	b	
fidelia	b	
fideliga	t	fideligna
fideligna	b	
fidelina	b	
fidelingna	t	fideligna
fidia	b	
figeligna	t	fideligna
filadefia	t	filadelfia
filadelfa	b	
filadelfia	b	
fildelia	b	
fildelina	b	
filedigna	t	fideligna
filia	b	
filolila	b	
filomena	b	
fiorela	b	
flabia	t	flavia
flacila	b	
flaminia	b	
flavia	b	
flaxila	b	
fleroberta	b	
floa	t	flor
floe	t	flor
flolrinda	t	florinda
flor	b	
flora	b	
floraida	b	
floralba	b	
floraminda	b	
florangel	b	
florangela	b	
florarba	t	floralba
flordelia	b	
flordelina	b	
flordenis	b	
flore	b	
florecinda	b	
floreida	b	
floreita	b	
florela	b	
florelba	b	
florelia	b	
florelina	b	
florelis	b	
florelmira	b	
florelva	b	
floremira	b	
florena	b	
florencia	b	
florency	b	
florenia	b	
florentina	b	
floreslida	b	
floreslinda	b	
floresmila	b	
floresminda	b	
floresmira	b	
floria	t	gloria
floriana	b	
floribertha	b	
florice	b	
floriceida	b	
floricelda	b	
floriceni	b	
floricia	b	
florida	b	
florides	b	
floridia	b	
florilba	b	
florina	b	
florinda	b	
florinfe	b	
florinsa	b	
floripa	b	
floripe	b	
floripedes	b	
floripes	b	
floripez	b	
floripis	t	floripes
floris	b	
florisa	b	
florisana	b	
floriscelda	b	
floriselda	b	
floriselva	b	
florisene	b	
floriseni	t	florisene
florismelda	b	
floritza	b	
florizelda	b	
florlisana	b	
flormaria	b	
flormeda	b	
florrelba	t	florelba
flortensia	b	
flortilde	b	
floxilia	b	
flro	t	flor
flroralba	t	floralba
for	t	flor
foralba	t	floralba
fortuna	b	
fortunata	b	
fosforica	b	
fracila	b	
fracilia	t	fracila
fracy	t	francy
fran	b	
francela	b	
franceliana	b	
francelina	b	
franceneth	b	
francenith	b	
frances	b	
franci	b	
francia	b	
francila	b	
francina	b	
francined	b	
francinelda	b	
francis	b	
francisca	b	
franciscana	b	
francisco	t	francisca
francisney	b	
franclix	b	
francois	b	
francy	b	
francys	t	francy
frank	b	
frankhelma	b	
franquelina	b	
franquia	b	
franselina	b	
fransi	t	franci
fransisca	t	francisca
frasina	b	
fraudelina	b	
fraxcila	b	
fraxedis	b	
fraxila	b	
fraxilia	b	
freddy	b	
fredes	b	
fredesbinda	t	fredesminda
fredesminda	b	
fredesvinda	t	fredesminda
fredi	b	
fredil	t	fredi
fredis	t	fredi
fredya	b	
freid	t	fredi
freina	b	
frencyne	b	
frerida	b	
fresia	b	
fresminda	b	
freyde	b	
frigith	t	brigith
frnacelina	t	francelina
frnanda	t	fernanda
frondina	b	
froralba	t	floralba
frorangela	t	florangela
fructuosa	b	
fulgencia	b	
fulvia	b	
gabi	b	
gabina	b	
gabriela	b	
gabrielina	b	
gabrileina	t	gabrielina
gabys	b	
gacilda	b	
gadys	t	gladys
gala	b	
galdys	t	gladys
gana	t	ana
garciela	t	graciela
garendalia	b	
gavina	b	
gaviota	b	
geaneth	b	
gedma	b	
geidy	b	
geitza	b	
gelnis	b	
gema	b	
gemma	b	
genara	b	
gendues	b	
gene	b	
genedi	b	
genesis	b	
geneth	b	
geneveve	b	
genid	b	
genis	b	
genisela	b	
genit	b	
genith	b	
genni	b	
gennis	b	
genny	b	
genobeva	t	genoveva
genove	b	
genoveba	t	genoveva
genoveva	b	
gentiil	t	gentil
gentil	b	
geny	b	
genys	b	
geoconda	b	
geomaris	b	
georgeth	b	
georgina	b	
geory	b	
geovana	b	
gerarda	b	
gerardina	b	
gereardina	t	gerardina
gerly	b	
germaine	b	
germana	b	
germania	b	
gerogina	t	georgina
geronima	b	
gerorgina	t	georgina
gertrudes	t	gertrudis
gertrudid	t	gertrudis
gertrudis	b	
gertrudiz	b	
gertrudys	b	
gertruides	t	gertrudis
gertudis	t	gertrudis
gertudris	t	gertrudis
gesbleidy	b	
getrudis	t	gertrudis
giber	b	
gicel	b	
gicela	b	
gicella	b	
gilberta	b	
gilbertina	b	
gilde	b	
gilede	t	gilde
gillermina	t	guillermina
gilma	b	
gilwy	b	
gimena	b	
gina	b	
gineht	b	
ginet	b	
gineth	b	
gineyda	b	
ginez	t	inez
ginna	b	
giomara	b	
gionana	t	giovana
giorgina	b	
giovana	b	
giovanna	b	
giranza	b	
girasol	b	
girleza	b	
gisela	b	
gisele	b	
gisell	b	
giselle	b	
giselli	b	
gissela	b	
gisselle	b	
gizeth	b	
glacidia	b	
gladia	b	
gladis	b	
gladiz	b	
gladlys	t	gladys
glady	t	gladys
gladyi	t	gladys
gladys	b	
gladyss	t	gladys
gladyz	t	gladys
glafys	t	gladys
glagys	t	gladys
glaribel	t	claribel
gldys	t	gladys
gledi	t	gladys
gledys	t	gladys
gleides	b	
gleidys	b	
gleisis	b	
glena	t	glenda
glenda	b	
glenia	b	
glenis	b	
glenys	b	
gleydis	b	
gliceria	b	
gliria	t	gloria
glloria	t	gloria
glma	t	gilma
globis	b	
gloira	t	gloria
glolria	t	gloria
glora	t	gloria
gloria	b	
glorias	t	gloria
glorid	t	gloria
gloriela	b	
glovis	b	
golria	t	gloria
gorecti	t	goreti
goreti	b	
goretti	b	
goretty	b	
gorety	b	
gorgonia	b	
goria	t	gloria
grace	b	
gracelina	b	
gracia	b	
gracialiana	t	graciliana
graciana	b	
graciel	b	
graciela	b	
gracielina	b	
gracila	b	
graciliana	b	
graiela	t	graciela
grciela	t	graciela
grecha	b	
grecia	b	
gredy	b	
gregoria	b	
gregorina	b	
greicy	b	
grened	b	
grenis	t	genis
greta	b	
griceida	b	
gricel	b	
gricelda	b	
griceldina	b	
gricelia	b	
grisalda	b	
grisaldina	b	
grisalia	b	
griselda	b	
griseldina	b	
griselia	b	
griselides	b	
griselina	b	
grogoria	t	gregoria
groria	t	gloria
gtloria	t	gloria
guadalup	t	guadalupe
guadalupe	b	
gudelia	b	
gudiela	b	
guelia	b	
guerly	b	
guidia	b	
guifran	b	
guilermina	t	guillermina
guillemina	t	guillermina
guillerma	b	
guillermina	b	
guimar	t	guiomar
guiomar	b	
guisela	t	gisela
guiselle	t	giselle
gullermina	t	guillermina
gumercinda	b	
gustabia	b	
gustavia	b	
gustina	b	
guvendalia	b	
gynna	b	
hadid	b	
hadime	b	
hael	b	
haida	b	
haide	b	
haidee	b	
haidive	b	
haidy	b	
haixa	b	
halena	t	helena
halli	b	
handry	b	
haracely	t	aracely
harlen	b	
harley	b	
hasbleydi	b	
hasley	b	
hasmin	t	jasmin
haybora	b	
haydde	t	haydee
hayde	b	
haydee	b	
haydy	b	
hdolores	t	dolores
hebania	b	
hechizada	b	
hecilia	t	hercilia
hedid	t	edid
hedofila	b	
heida	b	
heiddy	t	heidy
heide	b	
heidi	b	
heidy	b	
heila	b	
heimy	b	
hekena	b	
heladia	b	
helaine	b	
helania	b	
helda	b	
hele	b	
heleana	b	
helelna	t	helena
helen	b	
helena	b	
heleniet	b	
helfa	t	elfa
helga	b	
heli	b	
helia	b	
helian	b	
heliana	b	
helica	t	helida
helida	b	
helina	b	
heliodora	b	
helizabeth	t	elizabeth
helka	b	
hellen	b	
helly	t	nelly
helmira	t	elmira
helsy	t	elsy
helverta	b	
hemencia	t	hermencia
hemerita	t	emerita
heminia	t	herminia
hemir	t	emir
hena	b	
henira	b	
henith	t	enith
hennency	b	
henny	t	jenny
hennyt	b	
heny	b	
heraclia	b	
heraclita	b	
heralda	b	
herali	b	
hercel	b	
hercelia	b	
hercia	b	
hercilda	b	
hercilia	b	
hercilis	t	hercilia
hercinda	b	
hercy	b	
herecinda	t	hercinda
heremelinda	t	hermelinda
heremencia	t	hermencia
herenia	b	
heresmilda	b	
herevith	b	
herica	t	erica
hericinda	t	hercinda
herisinda	t	erisinda
herledy	b	
herli	b	
herlinada	t	herlinda
herlind	t	herlinda
herlinda	b	
herlis	b	
herlnda	t	herlinda
herly	b	
herma	b	
hermancia	b	
hermecia	b	
hermecinda	b	
hermelina	b	
hermelinda	b	
hermencia	b	
hermenegilda	b	
hermenncia	t	hermencia
hermeregilda	b	
hermesenda	t	hermesinda
hermesilda	b	
hermesinda	b	
hermidez	b	
hermidia	b	
hermigia	b	
hermila	b	
hermilda	b	
hermina	b	
herminda	b	
herminia	b	
hermninia	t	herminia
hernencia	b	
herneyda	b	
hernimia	t	herminia
heroina	b	
hersilia	b	
hersy	b	
hesilda	b	
hesnider	b	
heteb	b	
hetelinda	b	
hevelia	t	evelia
heyda	b	
heydee	t	aydee
heydi	b	
heydy	b	
hhumbertara	t	humberta
hibert	b	
hidaira	b	
hidali	b	
hidalith	b	
hidaly	b	
hidia	b	
hidio	b	
hido	t	hidio
hidu	t	idu
higinia	b	
hiilda	t	hilda
hila	t	hilda
hilaria	b	
hilba	b	
hilce	b	
hilda	b	
hilde	b	
hilet	b	
hilia	b	
hilma	b	
hilsa	b	
hilse	b	
hilva	b	
hilvania	b	
himelda	t	imelda
hinelda	b	
hipolita	b	
hipolito	t	hipolita
hirlen	b	
hirlena	b	
hirma	t	irma
hisela	t	gisela
hisnelda	t	isnelda
hitta	b	
hodalinda	b	
hodet	b	
hohora	t	nohora
holanda	b	
holga	b	
holinda	t	olinda
honoria	b	
horacia	b	
horensia	t	hortensia
hormilda	b	
hortecia	t	hortencia
hortencia	b	
hortencoa	t	hortencia
hortensia	b	
hostilia	b	
hreminia	t	herminia
hrmencia	t	hermencia
hudelina	b	
huergo	t	huerto
huerto	b	
huga	b	
huguet	b	
hugueth	b	
humbelina	b	
humberta	b	
humbertina	b	
humelia	b	
hungria	b	
huriel	t	uriel
hypathia	b	
iared	b	
ibed	b	
ibeeth	t	ibeth
ibel	b	
ibet	b	
ibetd	t	ibeth
ibeth	b	
ibette	b	
ibh	t	ibeth
ibonne	t	ivonne
ibsen	t	ilsen
icela	b	
icelina	b	
ida	t	aida
idalba	b	
idale	b	
idali	b	
idalia	b	
idalid	b	
idalides	b	
idaliht	b	
idalina	b	
idalit	b	
idalith	b	
idally	b	
idaly	b	
idalys	b	
idanis	b	
ided	b	
idelcy	t	delcy
idelda	b	
idelfa	b	
idelfina	t	delfina
ideli	b	
idelia	b	
idelsa	b	
iderly	b	
idey	b	
idilia	t	edilia
idma	t	irma
idolivia	b	
idth	t	edith
idu	b	
iduvina	t	eduvina
iedy	t	leidy
ifalia	b	
ifigenia	t	efigenia
iginia	b	
ignacia	b	
iisabel	t	isabel
ikira	b	
iladit	t	idalit
ilba	b	
ilbania	b	
ilce	b	
ilcia	b	
ilda	b	
ildaura	b	
ilde	b	
ildelfonsa	b	
ildene	b	
ileana	b	
ilen	b	
ilia	b	
iliana	b	
ilischtna	b	
ilma	b	
ilsa	b	
ilse	b	
ilsen	b	
ilva	b	
ilvania	b	
ilvia	b	
imda	t	inmaculada
ime	b	
imelda	b	
imeldina	b	
imia	b	
imleda	t	imelda
imslian	b	
ina	b	
indalecia	b	
inderlina	b	
indi	b	
indira	b	
indlecia	t	indalecia
indovina	b	
indra	b	
indrid	t	ingrid
indy	b	
inees	t	ines
inel	b	
inelda	b	
inelia	b	
inelita	b	
inelsa	b	
inelse	t	inelsa
inercia	b	
ines	b	
inez	b	
ingracia	t	engracia
ingri	b	
ingrid	b	
ingrit	b	
ingryth	b	
iniocencia	t	inocencia
iniria	t	inirida
inirida	b	
inmaculada	b	
inmelda	t	imelda
inna	b	
inocelvira	b	
inocencia	b	
inti	b	
invita	b	
iraida	b	
iraima	b	
iralba	b	
irayda	b	
ireima	b	
irena	b	
irene	b	
ireneo	t	irene
irenia	b	
ireth	b	
iria	b	
irialet	b	
irianda	b	
irida	b	
irien	b	
irinael	b	
iris	b	
irisinda	b	
irlanda	b	
irlena	b	
irlene	b	
irley	b	
irma	b	
irmenda	b	
irsa	b	
isabael	t	isabel
isabe	t	isabel
isabel	b	
isabela	b	
isabelina	b	
isabelita	b	
isabet	b	
isabeth	b	
isabl	t	isabel
isadora	b	
isamel	t	isabel
isaulina	b	
isaura	b	
isbael	t	isabel
isbelga	b	
isbelia	b	
isbelina	b	
isbenia	b	
isbeth	b	
isbnel	t	isabel
isdelia	b	
isdora	t	isadora
isela	b	
isidora	b	
isidra	b	
isilda	b	
isilina	t	isolina
isis	b	
isla	b	
islanda	b	
islena	b	
islenia	b	
isleny	b	
isley	b	
ismaela	b	
ismaelina	b	
ismedia	b	
ismelda	b	
ismenia	b	
ismenial	t	ismenia
ismrnia	t	ismenia
isneda	t	esneda
isneida	b	
isnelda	b	
isolina	b	
isolinna	t	isolina
israelita	b	
istel	b	
istmenia	t	itsmenia
isulinda	b	
isvelia	b	
italia	b	
itbeth	t	ibeth
itsmenia	b	
iva	t	eva
ivany	b	
ived	b	
ivet	b	
iveth	b	
ivette	b	
ivis	t	iris
ivon	b	
ivone	b	
ivoneth	b	
ivonne	b	
izabel	t	isabel
izalia	b	
izolina	t	isolina
jacinta	b	
jackelin	b	
jackeline	b	
jacoba	b	
jacobeth	b	
jacovinda	b	
jacqueline	b	
jaddy	b	
jadeyi	b	
jadime	b	
jadith	b	
jael	b	
jaenette	t	jeanette
jaenth	b	
jagcibe	b	
jahel	b	
jaibleydi	b	
jaide	b	
jaidid	b	
jaidith	b	
jaidy	b	
jaine	b	
jakelin	b	
jakeline	b	
jalile	b	
jalith	b	
jamina	b	
jane	b	
janedth	t	janeth
janeht	t	janeth
janelli	b	
janet	b	
janeth	b	
janett	b	
janette	b	
janier	b	
janine	b	
janis	b	
janith	b	
janne	b	
jannet	b	
janneth	b	
jannett	t	janneth
jannette	b	
jaquelin	b	
jaquelina	b	
jaqueline	b	
jarimen	b	
jaris	b	
jarley	b	
jasbleidy	b	
jasmin	b	
jasmine	b	
jasmira	b	
jaudice	b	
jaureli	t	aureli
jazbleidi	b	
jazmid	t	jazmin
jazmin	b	
jazmine	b	
jeanet	b	
jeaneth	b	
jeanethe	b	
jeanetta	t	jeanette
jeanette	b	
jeannet	b	
jeannete	b	
jeanneth	b	
jeannette	b	
jeaquelina	t	jaquelina
jehany	b	
jehudy	b	
jeidy	b	
jeimy	b	
jeineth	b	
jeinny	b	
jeiny	b	
jemilda	t	emilda
jena	b	
jenacia	b	
jeneth	t	janeth
jenethe	t	janeth
jenifer	b	
jeniffer	b	
jenith	b	
jenixfer	t	jenifer
jenni	b	
jennifer	b	
jenniffer	b	
jenny	b	
jenoveba	t	genoveva
jeny	b	
jenyfer	b	
jeomar	t	jiomar
jeorgina	b	
jermy	b	
jeronima	b	
jeronina	t	jeronima
jesica	b	
jesika	b	
jesley	b	
jessica	b	
jesusa	b	
jeymmi	b	
jhadira	b	
jhanet	b	
jhaneth	b	
jhayne	b	
jheinny	b	
jhoana	b	
jhoelma	b	
jhohana	b	
jhona	t	jhoana
jhovana	b	
jhovanna	b	
jianeth	t	janeth
jilma	b	
jimena	b	
jinet	b	
jineth	b	
jinna	b	
jinny	b	
jiomar	b	
jisset	b	
jitendra	b	
joan	b	
joana	b	
joane	b	
joanna	b	
joanne	b	
joaquina	b	
joba	b	
jobita	b	
jocabet	b	
jocabett	b	
jocoba	b	
johaana	t	johana
johana	b	
johanna	b	
johannely	b	
johilen	b	
johna	b	
jojana	t	johana
jokabeth	b	
joliana	t	juliana
jolima	t	yolima
jolin	b	
joly	b	
jomar	b	
jonaha	t	johana
jonnet	b	
jorleny	b	
joseane	b	
josefa	b	
josefina	b	
joselina	b	
joselita	b	
josely	b	
joule	b	
jova	b	
jovana	b	
jovanna	b	
jovita	b	
joyce	b	
juana	b	
juaneth	b	
juanita	b	
juany	b	
juaquina	b	
juddith	t	judith
judhit	t	judith
judidt	b	
judiht	b	
judit	b	
judith	b	
judth	t	judith
judy	b	
judyd	b	
juileth	t	julieth
jula	t	julia
juli	b	
julia	b	
juliana	b	
julie	b	
juliet	b	
julieta	b	
julieth	b	
juliette	b	
julissa	b	
julith	b	
jullie	b	
jully	b	
july	b	
junet	b	
juniet	b	
jusith	b	
justa	b	
justina	b	
justiniana	b	
jydi	b	
kala	b	
kalajan	b	
karen	b	
karimme	b	
karin	b	
karina	b	
karine	b	
karla	b	
karley	b	
karol	b	
karold	b	
katerin	b	
katerine	b	
katherin	b	
katherine	b	
katherinne	b	
katheryne	b	
kathiuska	b	
katterine	b	
katty	b	
kelina	b	
keller	b	
kelly	b	
kely	b	
ket	b	
keterin	b	
ketty	b	
kim	b	
kimi	b	
kirpa	b	
kora	b	
krystal	b	
kyara	b	
la	b	
labeniz	b	
lacira	t	alcira
lady	b	
ladys	b	
lagia	t	ligia
laidisa	b	
laila	b	
laily	b	
lairen	b	
laisney	b	
laly	b	
lana	b	
lanir	b	
lara	b	
laritza	b	
lartha	t	martha
las	b	
lastenia	b	
laudelina	b	
laudi	b	
laudice	b	
laudicia	b	
laudis	b	
laudith	b	
laudy	b	
laudys	b	
lauli	b	
laura	b	
laurasia	b	
laureana	b	
lauren	b	
laurena	b	
laurencia	b	
laurencita	b	
laureni	b	
laydy	b	
layne	b	
laysema	b	
lcy	b	
lea	b	
leady	b	
leandra	b	
leaned	b	
leas	b	
leb	t	lebi
lebi	b	
leda	b	
leddy	b	
ledis	b	
ledy	b	
ledys	b	
legui	b	
leida	b	
leidi	b	
leidis	b	
leidy	b	
leila	b	
leimer	b	
leira	b	
leis	b	
leisa	b	
leislie	b	
leisvy	b	
leisy	b	
lel	b	
leli	b	
lelia	b	
lelis	b	
lelly	b	
lely	b	
lelys	b	
lemir	t	emir
lena	b	
lency	b	
lendy	b	
lenit	b	
lenny	b	
lennys	b	
leny	b	
lenya	b	
lenys	b	
leocadia	b	
leodid	b	
leoduvina	b	
leody	b	
leogigilda	t	leovigilda
leomarys	b	
leomira	b	
leona	b	
leonarda	b	
leoncia	b	
leoneida	b	
leonela	b	
leonelli	b	
leoneyra	b	
leonice	b	
leonicia	b	
leonide	b	
leonides	b	
leonilda	b	
leonilde	b	
leonisa	b	
leoniza	b	
leonor	b	
leonora	b	
leonos	t	leonor
leopolda	b	
leopoldina	b	
leovicelda	b	
leovigilda	b	
leoviglda	t	leovigilda
leovilgilda	t	leovigilda
leovina	b	
leozaida	b	
lepoldina	b	
lepsa	b	
leria	b	
lerins	b	
lesbia	b	
leseth	t	liseth
lesly	b	
lesvia	b	
leticia	b	
letty	b	
lety	b	
leudi	b	
leudice	b	
leudina	b	
leudise	b	
leusmila	t	luzmila
leyda	b	
leyde	t	leyda
leyden	b	
leyder	b	
leydi	b	
leydy	b	
leyla	b	
lez	t	luz
lezeth	t	lizeth
lforalba	t	floralba
lia	b	
liana	b	
libbi	b	
libe	b	
libeidy	b	
liberata	b	
libertad	b	
libertada	b	
liberty	b	
libeth	b	
libi	b	
libia	b	
libida	b	
liboria	b	
librada	b	
liby	b	
lice	t	ilce
liced	b	
licedth	b	
liceli	b	
licenia	b	
licet	b	
liceta	b	
liceth	b	
licette	b	
lichen	b	
licia	b	
licila	t	lucila
licinda	b	
licinia	b	
licitacion	b	
lid	t	lida
lida	b	
lidaura	b	
liday	b	
lidder	b	
lide	b	
liden	b	
lides	b	
lidia	b	
lidibeth	b	
lidilia	b	
lidna	b	
lidovina	b	
liduena	b	
liduina	b	
liduvina	b	
lidya	b	
ligeya	b	
ligia	b	
lijia	t	ligia
lila	b	
lilecth	b	
liley	b	
lili	b	
lilia	b	
liliam	b	
lilian	b	
liliana	b	
lilibelt	t	lilibet
lilibet	b	
lilibeth	b	
lilihet	b	
lilis	b	
liliveth	b	
lilla	b	
lillers	b	
lillet	b	
lilliana	t	liliana
lilly	b	
lily	b	
lilyam	b	
lilyan	b	
lilyana	b	
lima	b	
limbania	b	
lin	b	
lina	b	
linbania	t	limbania
linda	b	
lindabra	b	
lindania	b	
lindaria	b	
lindas	b	
lindaura	b	
lindelia	b	
lindora	b	
lindura	b	
lineis	t	ines
liney	b	
linith	b	
lipia	t	libia
lira	b	
liral	t	lira
liria	b	
lirien	b	
liry	b	
lis	b	
lisa	b	
lisana	b	
lisandra	b	
lisaura	t	isaura
lisbery	b	
lisbet	b	
lisbeth	b	
lise	b	
lised	b	
liset	b	
liseth	b	
lisette	b	
lisidia	b	
lisinia	b	
lisleny	b	
lisnelia	b	
lisney	b	
lisset	b	
lissete	b	
lisseth	b	
lissett	b	
lissette	b	
lissey	b	
lisve	b	
lita	b	
litavira	b	
litay	b	
lith	b	
litz	b	
liuna	t	luna
live	b	
livia	b	
livida	t	livia
livy	b	
lix	t	liz
lixarely	b	
liyan	b	
liyid	b	
liyy	b	
liz	b	
liza	b	
lizandra	b	
lizaura	b	
lizbeth	b	
lizbey	b	
lizceth	b	
lizet	b	
lizeth	b	
lizethe	b	
lizett	b	
lizette	b	
lizhamadt	b	
lizzet	b	
llaned	b	
lodovina	b	
lodubiba	b	
loenilde	t	leonilde
loga	t	olga
loida	b	
loidover	b	
lola	b	
lolo	t	lola
loly	b	
longa	b	
longeva	b	
loo	t	los
lora	b	
loraine	b	
lorelba	b	
loreley	b	
lorelia	b	
lorella	b	
lorely	b	
loren	b	
lorena	b	
lorenia	b	
lorenza	b	
lorey	b	
loris	b	
los	b	
lourde	b	
lourdes	b	
lourdez	b	
lovigilda	t	leovigilda
loyda	b	
lu	b	
lua	t	luz
luary	b	
lubdy	b	
lubeida	b	
lubi	b	
lubinia	b	
luby	t	ruby
lucedy	b	
lucela	b	
luceli	b	
lucelia	b	
lucelida	b	
lucelinda	b	
lucella	b	
lucelly	b	
lucely	b	
lucena	b	
lucencia	b	
luceni	b	
lucenia	b	
lucenit	b	
lucenith	b	
luceny	b	
lucera	b	
lucerida	b	
lucerito	b	
lucerminda	b	
lucero	b	
lucey	b	
luceye	b	
luceyen	b	
lucha	b	
luchas	b	
luci	b	
lucia	b	
luciana	b	
lucidia	b	
lucila	b	
lucilda	b	
lucinda	b	
lucinia	b	
lucita	b	
lucrcia	t	lucrecia
lucre	b	
lucrecia	b	
lucua	t	lucia
lucula	t	lucila
lucy	b	
luddy	b	
ludeimar	b	
ludeisy	b	
ludes	b	
ludi	b	
ludis	b	
ludivia	b	
ludobina	b	
ludolfia	b	
ludomina	b	
ludoris	b	
ludoteca	b	
ludovina	b	
ludoviva	t	ludovina
ludrecia	t	lucrecia
luduvina	t	ludovina
ludy	b	
ludys	b	
lufan	b	
lugarda	b	
lugdy	b	
luica	t	lucia
luicia	t	lucia
luicita	b	
luidi	b	
luidina	b	
luilia	t	lilia
luilly	t	lilly
luizs	t	luz
luldary	t	luzdary
lulia	t	julia
lulid	b	
lulieth	b	
lulila	b	
lulo	b	
lulu	b	
lulvi	b	
lumey	b	
lumgmey	t	lumey
lumina	b	
luna	b	
lunas	t	luna
luney	b	
luns	t	luna
lupe	b	
luperli	b	
lupy	b	
lurdes	t	lourdes
lurenia	b	
lury	b	
lusinda	b	
luterana	b	
lutgarda	b	
luth	b	
luvida	b	
lux	b	
luxora	b	
luxy	b	
luz	b	
luzaira	b	
luzbei	b	
luzbelia	b	
luzbrey	b	
luzcelly	b	
luzcely	b	
luzdary	b	
luzday	t	luzdary
luzdelia	b	
luzdivia	b	
luzeida	b	
luzma	b	
luzmary	b	
luzmery	b	
luzmidia	b	
luzmila	b	
lyda	b	
lydda	t	lyda
lydia	b	
lydis	t	ledys
lydya	b	
lylia	b	
lynne	b	
lys	b	
lysseth	b	
lytha	b	
lyz	b	
lz	t	luz
maaria	t	maria
maarina	t	marina
mabe	b	
mabel	b	
mabell	b	
mabet	b	
mabilia	b	
mabir	b	
maby	b	
macarena	b	
macdalena	t	magdalena
macedonia	b	
madadeleine	t	madeleine
madan	b	
maddy	b	
madela	b	
madeleine	b	
maderline	b	
madgalena	t	magdalena
madie	b	
madiney	b	
mady	t	mary
maecela	t	marcela
maela	b	
maetha	t	martha
mafre	b	
mafria	b	
mag	b	
magada	t	magda
magadalena	t	magdalena
magadelana	t	magdalena
magale	t	magali
magali	b	
magaly	b	
magda	b	
magdalena	b	
magdaly	t	magaly
magdy	b	
magliony	b	
magnolia	b	
magnoly	b	
magoa	t	magola
magola	b	
magreth	b	
magyury	b	
maholy	b	
maia	t	maria
maide	b	
maiden	b	
maidoceny	b	
maiela	b	
maigenda	b	
mailor	b	
maira	b	
maireli	b	
mairely	b	
mairyam	t	miryam
maite	b	
maithe	b	
majia	t	maria
majin	b	
majurga	b	
maladei	b	
malely	b	
malena	b	
maleny	t	marleny
malfi	b	
malge	b	
malgi	b	
malia	b	
malva	b	
mamerta	b	
mamria	t	maria
mamrisol	t	marisol
mancy	t	nancy
mandy	b	
manfis	b	
manfre	b	
manilline	b	
mankla	b	
manora	b	
mañria	t	maria
mansalva	b	
mansella	b	
manuela	b	
manuelina	b	
manyeli	b	
manyeny	b	
maqrtha	t	martha
mar	b	
mara	t	maria
marai	t	maria
maraia	t	maria
maramay	b	
maraoia	t	maria
marba	b	
marbel	b	
marbela	b	
marbeli	b	
marbeliz	b	
marbella	b	
marbelly	b	
marbeluz	b	
marbely	b	
marbery	b	
marby	b	
marcedes	t	mercedes
marcedonia	b	
marcela	b	
marcelas	t	marcela
marcelenda	b	
marcelina	b	
marcelli	b	
marci	b	
marcia	b	
marciana	b	
marcila	b	
marcleina	b	
marcy	b	
mardelia	b	
mareia	b	
mareibi	b	
marelbis	b	
marelby	b	
mareli	b	
marelvi	b	
marelvis	b	
marelvy	b	
marely	b	
maren	b	
marfa	b	
marfelia	b	
marffa	b	
marfia	b	
marfild	b	
margaita	t	margarita
margaret	b	
margareth	b	
margarira	t	margarita
margarita	b	
margaritaq	t	margarita
margaritsa	b	
margartia	t	margarita
margeli	b	
margen	b	
margery	b	
margi	b	
margie	b	
margot	b	
margoth	b	
margy	b	
margye	b	
marha	t	martha
marhta	t	martha
mari	b	
maria	b	
mariai	t	maria
marial	t	maria
mariam	b	
marian	b	
marianela	b	
mariany	b	
marias	b	
maribel	b	
maribeth	b	
maribony	b	
mariby	b	
marice	b	
maricel	b	
maricela	b	
maricelda	b	
maricielo	b	
maricla	t	maricela
maridelsa	b	
marie	b	
mariebl	t	maribel
mariel	b	
mariela	b	
marielena	b	
marielina	b	
marielisa	b	
mariely	b	
mariem	b	
marien	b	
marieta	b	
marietha	b	
marietta	b	
marigusta	b	
marilce	b	
marilcen	b	
marilen	b	
marili	b	
marilia	b	
marilin	b	
marilis	b	
mariliz	b	
marilsa	b	
marilu	b	
mariluiz	t	mariluz
mariluna	b	
mariluz	b	
marily	b	
marilyn	b	
marima	t	marina
marina	b	
marineidy	b	
marinel	b	
marinela	b	
marinelba	b	
marinelda	b	
marinella	b	
marinelly	b	
marinelsa	b	
marinely	b	
marinelya	b	
marinilce	b	
mariny	b	
mario	t	maria
marion	b	
mariquita	b	
maris	b	
marisa	b	
marisel	b	
marisela	b	
marisella	b	
mariso	b	
marisol	b	
marissela	b	
marita	b	
marithza	b	
maritsa	b	
marittza	b	
maritza	b	
mariua	t	maria
marivel	b	
marixa	b	
marixe	b	
mariz	b	
mariza	b	
marizela	t	marisela
marizol	t	marisol
marjorie	b	
marle	b	
marleidy	b	
marlelly	b	
marlen	b	
marlena	b	
marlene	b	
marleng	b	
marleni	b	
marlenia	b	
marlenis	b	
marlenn	b	
marlenne	b	
marlenny	b	
marleny	b	
marles	b	
marlesby	b	
marley	b	
marlides	b	
marlinda	b	
marline	b	
marlli	b	
marlly	b	
marlovia	b	
marly	b	
marlyn	b	
marna	b	
marney	b	
maroia	t	maria
marola	b	
maroligna	b	
marolinda	b	
maroly	b	
marora	b	
marrleny	t	marleny
marrory	b	
marsella	b	
marsori	b	
marta	b	
martah	t	martha
martaha	t	martha
martga	t	martha
marth	t	martha
martha	b	
marthas	b	
martina	b	
martiniana	b	
martisa	t	maritza
martiza	t	maritza
martza	t	maritza
maruia	t	maria
maruja	b	
mary	b	
marya	b	
maryam	b	
maryan	b	
marybed	b	
marybel	b	
maryeli	b	
maryely	b	
maryen	b	
maryi	b	
maryit	b	
maryle	b	
marylena	b	
marylin	b	
marylu	b	
maryluz	b	
marynela	b	
marynelva	b	
maryon	b	
maryori	b	
maryoris	b	
maryory	b	
marysol	b	
maryu	b	
maryud	b	
maryuri	b	
maryury	b	
massiel	b	
matha	t	martha
matide	t	matilde
matilda	b	
matilde	b	
matina	t	marina
matlde	t	matilde
matrha	t	martha
matri	b	
matria	t	maria
matulde	t	matilde
matulia	b	
matutina	b	
maubel	b	
maura	b	
maureen	b	
mauren	b	
mauricia	b	
mauta	t	maura
mavel	b	
mavimina	b	
mavis	b	
max	b	
maxiliana	b	
maxima	b	
maximiliama	t	maximiliana
maximiliana	b	
maximina	b	
may	b	
maya	b	
mayarlen	b	
mayda	b	
mayde	b	
mayden	b	
maydu	b	
mayec	b	
mayela	b	
mayelly	b	
mayely	b	
mayen	b	
mayerby	b	
mayercy	b	
mayerli	b	
mayerlin	b	
mayerly	b	
mayeyly	b	
mayi	b	
mayilin	b	
mayin	b	
mayola	t	magola
mayolie	b	
mayoly	b	
mayory	b	
mayra	b	
mayrobis	b	
mayte	b	
mayuribet	b	
mayury	b	
mecedes	t	mercedes
medgibina	b	
mehlylin	b	
mei	b	
meira	b	
mela	b	
melani	b	
melania	b	
melanina	b	
melany	b	
melavicidec	b	
melba	b	
melby	b	
melchora	b	
melcy	b	
melesia	b	
melfi	b	
melfis	b	
melgi	b	
melia	b	
melida	b	
melina	b	
melinda	b	
melisa	b	
melissa	b	
melitza	b	
melki	b	
melonia	b	
melquicea	b	
melquiz	b	
melva	b	
melvina	b	
mely	b	
menerly	b	
menfis	b	
merady	b	
meralda	b	
meranda	b	
merarda	b	
mercades	t	mercedes
mercede	t	mercedes
mercedes	b	
mercedez	t	mercedes
mercees	t	mercedes
mercela	b	
mercely	b	
merces	b	
mercesa	b	
merceses	t	mercedes
merci	b	
mercy	b	
merecdes	t	mercedes
merecedes	t	mercedes
meredella	b	
meredes	t	mercedes
meredith	b	
meregilda	b	
merella	b	
merenciana	b	
meri	b	
meria	t	maria
merice	b	
mericia	b	
merida	b	
meris	b	
merita	b	
merjid	b	
merlen	b	
merleni	t	marleni
merline	b	
merly	b	
merminia	t	herminia
mery	b	
meryda	b	
meryluz	b	
meta	b	
metrodia	b	
mexy	b	
mey	b	
meydy	b	
meyi	b	
meylin	b	
mia	b	
micadelina	t	micaelina
micaela	b	
micaelina	b	
micailina	t	micaelina
micartina	b	
michel	b	
micsy	b	
mid	b	
mideya	t	mireya
midia	t	nidia
midy	b	
mielsa	b	
migdolia	b	
migdonia	b	
mignolia	t	magnolia
miguela	b	
miguelina	b	
miiriam	t	miriam
mikaela	b	
miladic	b	
miladis	b	
milady	b	
miladys	b	
milagro	b	
milagros	b	
milaida	b	
milba	b	
milca	b	
milce	b	
milcen	b	
milcy	b	
milder	b	
mildre	b	
mildred	b	
mildreth	b	
mildrey	b	
mile	b	
miled	b	
miledy	b	
miledys	b	
mileidy	b	
milen	b	
milena	b	
mileni	b	
mileny	b	
milet	b	
miley	b	
mileydi	b	
milgen	b	
milgred	b	
milia	b	
miliam	b	
milian	b	
militza	b	
millared	b	
milna	b	
milore	b	
milta	b	
milvia	b	
milvida	b	
mily	b	
mimiya	b	
mimriam	t	miriam
mina	b	
minarcy	b	
minda	b	
mindred	b	
mindrey	b	
minerva	b	
mini	b	
minolda	b	
minry	b	
minta	b	
miny	b	
minyely	b	
mira	b	
miralba	b	
miralda	b	
miramda	t	miranda
miranada	t	miranda
miranda	b	
mirando	t	miranda
mireida	b	
mireidy	b	
mirela	b	
mirella	b	
mirelta	b	
mirey	b	
mireya	b	
mireye	t	mireya
miria	b	
miriam	b	
miriamn	t	mirian
mirian	b	
mirlady	b	
mirlelly	b	
mirley	b	
mirna	b	
mirosalva	b	
mirta	b	
mirtha	b	
miryam	b	
miryan	b	
miryani	b	
miryma	t	miryam
mirza	b	
misaelina	b	
misalia	b	
misis	b	
mityam	t	miryam
miyared	b	
miyerlan	b	
miyiam	t	miryam
miyired	b	
miyryam	t	miryam
mmaria	t	maria
mmarleny	t	marleny
mmartha	t	martha
mmyrian	t	myrian
mnonica	t	monica
modesta	b	
moemi	t	nohemi
mohemi	t	nohemi
molly	b	
mona	t	mora
monia	t	monica
monica	b	
monoca	t	monica
monserrat	b	
mora	b	
moraima	b	
moralides	b	
morelia	b	
morelis	b	
morels	b	
morely	b	
morena	b	
morery	b	
moris	b	
mouriel	t	muriel
mraia	t	maria
mria	t	maria
mriam	t	miriam
mrina	t	marina
mrry	t	mary
mrtha	t	martha
mry	t	mary
mryam	t	miryam
mryen	t	maryen
msrisol	t	marisol
mueriel	t	muriel
muguet	b	
mugueth	b	
mugueti	b	
mura	b	
muria	t	maria
muriel	b	
musola	b	
myla	b	
myladis	b	
mylady	b	
myreya	b	
myria	b	
myriam	b	
myrian	b	
myruan	t	myrian
myryam	b	
myryan	b	
na	t	ana
naci	t	nancy
naciana	b	
naciancena	b	
nacira	b	
nacy	t	nancy
nadia	b	
nadid	b	
nadime	b	
nadined	b	
nadiz	b	
nadja	t	nadia
nadudy	b	
nadyuby	b	
nagales	b	
nahidu	b	
nahir	b	
nahora	t	nohora
naida	b	
naidu	b	
naiduc	b	
naila	b	
nair	b	
naira	b	
nairp	t	nair
nalda	b	
nalinde	b	
nalsy	t	nelsy
naly	b	
nan	b	
nanci	b	
nancy	b	
nanoy	b	
nansy	t	nancy
nany	t	nancy
naomi	b	
narcila	b	
narcinda	b	
narciza	b	
narcy	b	
narda	b	
nardi	b	
nardis	b	
nardy	b	
nariela	t	mariela
narina	t	marina
narisol	t	marisol
narlin	b	
narlis	b	
narlly	b	
narvi	b	
nasaria	b	
nasarith	b	
nasira	b	
nasly	b	
nasville	b	
natali	b	
natalia	b	
natalie	b	
nataly	b	
nathali	b	
nathalie	b	
natilde	t	matilde
natilid	b	
nativa	b	
natividad	b	
natividd	t	natividad
natividea	b	
natvidad	t	natividad
naty	b	
naudis	b	
naudit	b	
naudy	b	
naveiba	b	
navia	b	
nay	b	
nayda	b	
naydu	b	
nayi	b	
nayibe	b	
nayibeth	b	
nayir	b	
nayive	b	
nayla	b	
naylle	b	
nayube	t	nayibe
nayury	b	
nazareth	b	
nazaria	b	
nazarias	b	
nazly	b	
ndolores	t	dolores
necty	b	
nedeira	b	
nedie	b	
nedy	b	
neftalia	b	
negly	b	
nehemi	t	nohemi
nehocia	b	
neida	b	
neides	b	
neidi	b	
neidis	b	
neidy	b	
neife	b	
neiffy	b	
neifi	b	
neigy	b	
neila	b	
neilan	b	
neina	t	nina
neira	b	
neisan	b	
neisy	b	
neity	b	
neiva	b	
neivy	b	
neiza	b	
nelba	b	
nelbi	b	
nelchy	b	
nelci	b	
nelcis	t	nelci
nelcy	b	
nelda	b	
nelfa	b	
nelfi	b	
nelfuris	b	
nelfy	b	
neli	b	
nelia	b	
nelida	b	
nelis	b	
nelisol	b	
nelli	b	
nellis	b	
nelluy	t	nelly
nelly	b	
nellys	b	
nelma	b	
nelsa	b	
nelsi	b	
nelssy	t	nelsy
nelsy	b	
neluz	b	
nelva	b	
nelvi	b	
nelvis	b	
nelvy	b	
nely	b	
nelyda	b	
nelys	b	
nelza	b	
nemecia	b	
nemecis	t	nemesis
nemesia	b	
nemesis	b	
nena	b	
nency	b	
nenger	b	
nenny	b	
nenry	t	nery
nepomucena	b	
nerci	b	
nereida	b	
neretty	b	
nereyda	b	
nerida	b	
nerin	b	
neris	b	
nermy	b	
nersa	b	
nersi	b	
nery	b	
nerys	b	
nes	t	ines
nesbi	b	
nesky	b	
net	b	
neth	b	
netty	b	
neudis	b	
nevis	b	
neviyeil	b	
nevy	b	
newalia	b	
ney	b	
neyda	b	
neydis	b	
neydu	b	
neydy	b	
neyfe	b	
neyib	b	
neyidet	b	
neyla	b	
neylan	b	
neylb	t	neyib
neyle	b	
neyra	b	
neysa	b	
ngela	t	angela
nhora	b	
nibia	t	nubia
nibis	b	
nibolita	t	hipolita
nicacia	b	
nicanora	b	
nicasia	b	
nicola	b	
nicolasa	b	
nicolaza	b	
nicoll	b	
nidia	b	
nidiam	b	
nidian	b	
nidiya	t	nidya
nidya	b	
nidyan	b	
nidys	b	
niebes	t	nieves
niera	t	neira
nieve	b	
nieves	b	
nifa	t	ninfa
ñigia	t	ligia
nila	b	
nilce	b	
nilcia	b	
nilda	b	
nilde	b	
nilena	t	milena
nilfa	b	
nillian	b	
nilly	b	
nilma	b	
nilsa	b	
nilsan	b	
nilse	b	
nilsen	b	
nilza	b	
nimetalla	b	
nimia	b	
nina	b	
nine	b	
nineye	b	
ninfa	b	
ningracia	b	
nini	b	
ninia	b	
ninny	b	
ninsa	b	
niny	b	
ninza	b	
nira	b	
nirama	b	
niria	b	
nirida	b	
nirma	b	
nirsa	b	
niry	b	
nirza	b	
nived	b	
nives	t	nieves
nivia	b	
nixe	b	
niyereth	b	
niyireht	t	niyereth
niyireth	b	
nmaria	t	maria
noe	b	
noel	b	
noela	b	
noelba	b	
noeli	b	
noelia	b	
noeliz	b	
noelva	b	
noema	b	
noemi	b	
noemy	b	
noeni	t	noemi
nofre	b	
nohargenis	b	
noheli	b	
nohelia	b	
nohema	b	
nohemi	b	
nohemilsen	b	
nohemmi	t	nohemi
nohemmy	t	nohemy
nohemy	b	
nohora	b	
nohra	b	
noira	b	
nola	b	
nolaida	b	
nolberta	b	
nolbis	b	
nolfa	b	
noliva	t	oliva
nolma	t	norma
nolvis	b	
nominanda	b	
nona	b	
noneira	b	
noney	b	
nor	b	
nora	b	
noraida	b	
noraima	b	
noralba	b	
noralda	b	
noralice	b	
noralinda	b	
noralva	b	
norberta	b	
norbi	b	
norby	b	
norcelis	b	
nordia	b	
nordy	b	
noreday	t	noreyda
noreiva	b	
norel	t	norela
norela	b	
norelia	b	
norelida	b	
norelly	b	
norely	b	
noreyda	b	
norfa	b	
norgely	b	
norha	b	
nori	b	
noria	b	
noriela	b	
noris	b	
norleis	b	
norma	b	
normariela	b	
normine	b	
norvelia	b	
norvy	b	
nory	b	
norys	b	
novalgina	b	
noyer	b	
noyra	b	
nrlsy	t	nelsy
nubi	b	
nubia	b	
nubias	t	nubia
nubie	b	
nubiela	b	
nubier	b	
nubiola	b	
nubisa	b	
nubvia	t	nubia
nuby	b	
ñucia	t	lucia
nudibia	b	
nudya	t	nidya
nufay	b	
nulfa	b	
nully	t	nelly
nulmarina	b	
nulmes	b	
numa	b	
numaira	b	
numila	b	
numilia	b	
nuncia	b	
nunila	b	
nuny	b	
nur	b	
nure	b	
nuri	b	
nuria	b	
nuriam	b	
nurian	b	
nurilce	b	
nuris	b	
nurit	b	
nury	b	
nuvar	b	
nuvi	b	
nuvia	b	
nuvis	t	nuvia
ñuz	t	luz
nydia	b	
nydian	b	
nydya	b	
nyidia	t	nydia
nylena	b	
nynfa	b	
nyra	b	
nyrian	b	
oamaira	t	omaira
obaldina	b	
obdacia	b	
obdelina	b	
obdulia	b	
obdulina	b	
obeida	b	
obelia	b	
obeyda	b	
obilma	b	
ocadis	b	
ocaren	t	caren
ocaris	b	
ocaved	b	
occidelia	b	
ocladys	t	gladys
octalinda	b	
octalivar	b	
octavia	b	
octima	t	octimia
octimia	b	
odalina	b	
odalinda	b	
odalis	b	
odeida	b	
odelia	b	
odelinda	b	
oderay	b	
odila	t	odilia
odilia	b	
odilma	t	edilma
odis	b	
odofila	b	
odosinda	b	
odsolina	t	isolina
odulia	t	odilia
oefelia	t	ofelia
of	b	
ofela	t	ofelia
ofelda	b	
ofelia	b	
ofelin	b	
ofelina	b	
ofelma	b	
ofelmina	b	
ofely	b	
offir	t	ofir
ofil	t	ofir
ofilia	b	
ofir	b	
ofradi	b	
ofrocina	b	
oilia	t	lilia
ola	t	olga
oladia	t	claudia
olag	t	olga
olanda	b	
olaria	b	
olba	t	olga
oldemista	b	
olegaria	b	
oleisy	b	
oleocadia	t	leocadia
olfa	b	
olfenia	b	
olfilia	t	orfilia
olga	b	
olgal	t	olga
olgladys	t	gladys
olidia	b	
olimpa	b	
olimpia	b	
olinda	b	
olinta	b	
oliria	b	
olis	t	lis
oliva	b	
olivan	t	oliva
oliveida	b	
oliveira	b	
oliveria	b	
olivia	b	
olma	b	
olores	t	dolores
olova	t	oliva
olpidia	t	elpidia
olympia	b	
omaida	t	omaira
omaira	b	
omaria	t	omaira
omarira	t	omaira
omeida	b	
omelia	t	amelia
omelina	b	
onaida	b	
oneida	b	
onelia	b	
oneyda	b	
onofre	b	
onolba	b	
onpfre	t	onofre
oralia	b	
oralilia	b	
oralinda	b	
oramis	b	
orcinda	t	ercinda
ordulia	b	
oreina	t	reina
oresteres	t	orestes
orestes	b	
orfa	b	
orfary	b	
orfe	b	
orfelia	b	
orfelina	b	
orfelinda	t	orfelina
orfelmilda	t	orfelminda
orfelminda	b	
orfidia	b	
orfilia	b	
orfy	b	
orieda	b	
oriel	t	uriel
orla	b	
orladys	b	
orland	b	
orlanda	b	
orlandia	b	
orlandina	b	
orlas	t	orla
orlayda	b	
orle	b	
orleida	b	
orley	t	arley
orlinda	b	
orllyn	b	
orly	b	
ormilda	b	
ormilde	b	
orminda	b	
ornelis	b	
orolinda	b	
orosia	b	
orquidea	b	
ortencia	b	
osana	b	
osiris	b	
osmery	b	
osmidian	b	
osoria	b	
oster	t	ester
ostilia	t	otilia
otalba	b	
otalvis	b	
otiia	t	otilia
otilia	b	
otiliana	b	
otimio	b	
otlia	t	otilia
otocilia	b	
otolia	b	
otolicia	t	otocilia
otoselina	b	
otosilia	b	
oveira	b	
ovelia	b	
ovelin	b	
ovidia	b	
ovilde	b	
ovilerma	b	
ovilia	b	
pabla	b	
pablina	b	
pablinia	t	pablina
pacha	b	
pacifica	b	
pacion	t	pasion
pahola	b	
palom	t	paloma
paloma	b	
pamela	b	
panfila	b	
paol	t	paola
paola	b	
paquita	b	
parmenia	b	
pas	t	paz
pascuala	b	
pascula	t	pascuala
pasion	b	
pastora	b	
patrice	b	
patricinia	t	patrocinia
patrocina	t	patrocinia
patrocinia	b	
paublina	b	
paula	b	
paulia	t	paula
paulida	b	
paulin	b	
paulina	b	
pavia	b	
pawz	t	paz
paz	b	
penny	b	
pepa	b	
peregrina	b	
perla	b	
perpetua	b	
petra	b	
petrona	b	
petronica	b	
petronila	b	
pia	b	
piedad	b	
pilar	b	
pino	b	
pioquinta	b	
placeres	b	
placida	b	
placidia	b	
plauxcila	t	plauxila
plauxila	b	
plaxides	b	
plaxidia	b	
pnancy	t	nancy
poisidia	t	posidia
policarpa	b	
polidora	b	
polita	b	
polonia	b	
pompeya	b	
pompilia	b	
porfiria	b	
posidea	t	posidia
posidia	b	
potenciana	b	
pracedes	b	
pracedis	b	
pracedys	b	
pracjek	b	
prasedix	t	praxedes
praxedes	b	
praxedi	t	praxedis
praxedia	t	praxedis
praxedis	b	
precelia	b	
precelina	b	
precentacion	t	presentacion
preciada	b	
precilia	b	
prersentacion	t	presentacion
prescelia	b	
preselia	b	
presenta	b	
presentacion	b	
presilia	b	
prexedis	t	praxedis
priceida	b	
pricelia	b	
pricila	t	priscila
pricilia	b	
pricina	b	
primitiva	b	
priscelia	b	
priscila	b	
priscilia	t	priscila
prisciliano	b	
priseida	t	briseida
prisila	b	
prisilia	b	
prisilva	b	
procesa	b	
profelisa	b	
profetisa	t	profetiza
profetiza	b	
prospera	b	
proxedes	b	
proxedis	b	
prudencia	b	
publia	b	
puereza	t	pureza
pura	b	
puresa	b	
pureza	b	
purificacion	b	
qintana	t	quintana
quenis	b	
quilina	b	
quimena	t	gimena
quinana	t	quintana
quinta	b	
quintana	b	
quintanma	t	quintana
quintaria	t	quintana
quintiana	t	quintana
quintina	b	
quintna	t	quintana
quiomar	t	guiomar
quiquinquira	b	
quitana	t	quintana
quiteria	b	
qunta	t	quinta
rafaea	t	rafaela
rafael	t	rafaela
rafaela	b	
rafaelina	b	
raiden	b	
raimelda	b	
raimunda	b	
ramira	b	
ramona	b	
raosa	t	rosa
raquel	b	
raquelda	b	
raquelina	b	
raquilda	b	
rasa	t	rosa
rasalba	t	rosalba
rasana	t	rosana
rasaura	t	rosaura
rebeca	b	
redesminda	t	fredesminda
refa	b	
refugio	b	
refujio	t	refugio
regilda	b	
regina	b	
reiba	b	
reimunda	b	
reina	b	
reinabe	b	
reinalda	b	
reinangela	b	
reinela	b	
reinelda	b	
reinidad	b	
reiva	t	reina
reli	b	
relisa	t	elisa
remigia	b	
remilda	b	
rene	b	
reneida	b	
reoseli	t	roseli
requida	b	
requilda	b	
rerith	b	
resfa	b	
resura	b	
resureccion	b	
resurecion	t	resurreccion
resurreccion	b	
resurrecion	t	resurreccion
reveca	t	rebeca
reyita	b	
reyna	b	
reynalda	b	
reynelda	b	
rhonyce	b	
riana	t	triana
ricarcinda	b	
ricarda	b	
ricardina	b	
rimitiva	t	primitiva
rinna	b	
riomar	b	
riquelma	b	
riquilda	b	
riselma	b	
rita	b	
ritha	b	
roasa	t	rosa
roberta	b	
robertina	b	
robira	b	
roby	b	
robyn	b	
rocelia	b	
rocelina	b	
rocenda	b	
rocibel	b	
rocinda	b	
rocio	b	
rodenda	b	
rodulfa	b	
rogelia	b	
rojelia	t	rogelia
romalda	b	
romana	b	
romelia	b	
romelina	b	
romira	b	
romy	b	
ronny	b	
rony	b	
roquelia	b	
ros	t	rosa
rosa	b	
rosaa	t	rosa
rosabel	b	
rosabeth	b	
rosac	t	rosa
rosadelia	b	
rosaelvia	b	
rosahura	b	
rosai	t	rosa
rosaio	t	rosario
rosalba	b	
rosalbel	t	rosabel
rosalbina	b	
rosalbva	t	rosalba
rosalia	b	
rosalida	b	
rosalina	b	
rosalinda	b	
rosalio	t	rosario
rosalva	b	
rosalvina	b	
rosaly	b	
rosamelia	b	
rosamira	b	
rosan	t	rosana
rosana	b	
rosañba	t	rosalba
rosanda	b	
rosangela	b	
rosania	b	
rosarina	b	
rosario	b	
rosatilia	b	
rosatulia	b	
rosaura	b	
rosbely	b	
roscelly	b	
rosdalbina	t	rosalbina
rose	b	
roseda	b	
rosedel	b	
roselena	b	
roseli	b	
roselia	b	
roselin	b	
roselina	b	
roselinda	b	
roselis	b	
rosemary	b	
rosenda	b	
rosi	b	
rosibel	b	
rosid	b	
rosilma	b	
rosina	b	
rosinda	b	
rosio	t	rocio
rosirio	t	rosario
rosita	b	
roslba	t	rosalba
rosmari	b	
rosmary	b	
rosmelbi	b	
rosmelia	b	
rosmer	b	
rosmeri	b	
rosmery	b	
rosmira	b	
rosmyra	b	
ross	b	
rossana	b	
rosselly	b	
rossely	b	
rossi	b	
rossio	b	
rossmery	b	
rossy	b	
rosula	b	
rotth	t	ruth
rousella	b	
rouselle	b	
rovira	b	
roxana	b	
roxelda	b	
rpsa	t	rosa
rsa	t	rosa
rta	t	rita
rub	b	
rubby	b	
rubelly	b	
rubely	b	
rubi	b	
rubia	b	
rubiana	b	
rubibexi	b	
rubicintia	b	
rubiela	b	
rubielsa	b	
rubilia	b	
rubilma	b	
rubira	b	
rubirene	b	
rubis	b	
rubisla	b	
rubit	b	
rubria	b	
ruby	b	
rubyi	t	ruby
rubyn	b	
rubys	b	
rude	b	
rudecinda	b	
rudelia	b	
rudescinda	b	
rudesinda	b	
rudin	b	
rudis	b	
rudisbella	b	
rudith	b	
rudixa	b	
rudolfina	b	
rudy	b	
rudys	b	
rufina	b	
rufujio	t	refugio
rugeli	b	
ruht	t	ruth
rumalda	b	
rumilde	b	
rumira	b	
ruperta	b	
rupertina	b	
rusbi	b	
rusby	b	
rusmira	t	rosmira
russby	b	
rut	b	
rutbell	b	
rutby	b	
ruth	b	
ruthby	b	
ruthy	b	
rutn	t	ruth
ruvilma	b	
saarai	t	sara
sabet	b	
sabina	b	
sabys	b	
sacha	b	
saddy	b	
sadra	t	sandra
safia	b	
safira	b	
sagraria	b	
sagrario	b	
sahara	b	
sahira	b	
said	b	
saida	b	
saide	b	
saidia	t	saida
sail	b	
saimire	b	
saira	b	
saire	b	
salia	b	
salibeth	b	
salinda	b	
salome	b	
salustiana	b	
salustina	b	
salutacion	b	
salvadora	b	
sam	b	
samara	b	
samary	b	
samira	b	
samirna	b	
sammy	b	
sanadra	t	sandra
sanara	b	
sandalia	b	
sandra	b	
sandre	t	sandra
sandy	b	
sanelly	b	
sania	t	sonia
sanra	t	sandra
santina	b	
saofia	t	sofia
sara	b	
sarahi	t	sahira
sarai	b	
saraida	t	zoraida
saratiel	b	
sareli	b	
sarella	b	
sareth	b	
sari	b	
saria	b	
saridia	b	
sarina	b	
saro	b	
sartudina	t	saturdina
sasaria	b	
satulia	b	
saturdina	b	
saturia	b	
saturnina	b	
sauddy	b	
saudith	b	
saudy	b	
saula	b	
saulina	b	
savina	b	
sayda	b	
sayde	b	
sayder	b	
sebastiana	b	
secundina	b	
seferina	b	
sefora	b	
segismunda	b	
segunda	b	
segundina	b	
seidy	b	
seira	b	
seledonia	b	
selegne	b	
selena	b	
selene	b	
selenia	b	
selina	b	
selinda	b	
selmira	b	
selvilina	b	
semida	b	
senai	t	sinai
senaida	b	
sencion	b	
sened	b	
seneida	b	
senelia	b	
senelis	b	
senelly	b	
seneth	b	
senid	b	
senide	b	
senobia	b	
senovia	b	
sension	t	ascencion
senteh	t	seneth
serafina	b	
serapia	b	
serena	b	
sergia	b	
serley	b	
servanda	b	
serveliana	b	
sevelina	b	
severa	b	
severiana	b	
severina	b	
sevignet	b	
sharon	b	
sheila	b	
sheley	b	
shella	b	
sheney	b	
sherly	b	
shermari	b	
sheznarda	b	
shirley	b	
shyrlei	b	
sianai	b	
siba	b	
sibardia	b	
sibel	b	
sibela	b	
sibila	b	
sibilina	b	
siboney	b	
sichala	b	
sidia	b	
sidney	b	
sidra	b	
sierva	b	
sifia	t	sofia
sigria	t	siria
silbilina	t	sibilina
silda	b	
sildana	b	
silena	b	
silenia	b	
silia	t	cilia
silivia	t	silvia
silma	b	
silvana	b	
silvania	b	
silvaria	t	silvania
silvera	b	
silveria	b	
silvestra	b	
silvia	b	
silvina	b	
silvis	t	silvia
simona	b	
simone	b	
sinai	b	
sindi	b	
sindy	b	
sinforiana	b	
sinforosa	b	
siomara	b	
sircunsicion	t	circunsicion
siria	b	
sirivana	b	
sirleis	b	
sirley	b	
sirva	t	sierva
sisney	b	
sivilina	b	
sixmena	t	ximena
sixta	b	
sixtina	b	
slvia	t	silvia
smile	b	
smit	b	
smyth	b	
snadra	t	sandra
snedy	b	
snirna	b	
sobeida	b	
sobelly	b	
soberana	b	
sobeyda	b	
socorro	b	
soffy	b	
sofia	b	
soila	b	
sol	b	
solagne	b	
solain	b	
solange	b	
solangel	b	
solangela	b	
solanger	b	
solangi	b	
solangy	b	
solanlli	b	
solanlly	b	
solanry	b	
solany	b	
solanye	b	
solanyi	b	
solar	b	
soldeycy	b	
soleda	t	soledad
soledad	b	
soleida	b	
soley	b	
solfia	b	
solfidia	b	
solgenia	b	
solila	b	
solina	b	
solingen	b	
solis	b	
soliz	t	solis
solvey	b	
solvia	b	
somalia	b	
sonia	b	
sonnia	t	sonia
sophie	b	
sor	b	
soraida	b	
soraima	b	
sorama	b	
sorangel	b	
sorangela	b	
sorangy	b	
sorani	b	
soranny	b	
sorany	b	
soranyi	b	
soray	b	
soraya	b	
sorayda	b	
soreya	b	
soreyi	b	
sorleny	b	
sorley	b	
sormelania	b	
sormelida	b	
sormireya	b	
sorna	b	
sorsa	b	
sorsiomara	b	
sory	b	
sosima	b	
st	b	
stefani	b	
stefania	b	
steffanny	b	
stefhanie	b	
stela	b	
stella	b	
stephanny	b	
ster	b	
sterh	b	
sthefany	b	
sthella	b	
sthepanie	b	
sther	t	esther
strella	t	estrella
sttella	t	stella
subeida	b	
sublema	b	
sucecion	b	
sucel	b	
sucene	b	
sue	b	
suel	b	
sugey	b	
suiza	b	
sujey	b	
sula	b	
sulady	b	
sulay	b	
suleima	b	
sulema	b	
sulfey	b	
suliet	b	
sulieth	b	
sulima	b	
sulinda	b	
sulma	b	
sulman	b	
sulmira	b	
suly	b	
sumelia	b	
sumilda	b	
suncion	t	asuncion
sunilda	b	
sunilde	b	
sunlly	b	
surala	b	
surelly	b	
surely	b	
surey	b	
sureya	b	
surley	b	
surline	b	
susan	b	
susana	b	
susen	b	
sussy	b	
susuna	b	
suzana	b	
suzette	b	
sylvia	b	
tadea	b	
tadiana	t	tatiana
taide	t	aide
talia	b	
talita	b	
tamara	b	
tania	b	
tarcila	b	
tarquina	b	
tarsila	b	
tati	b	
tatiana	b	
tatitana	t	tatiana
tebel	b	
telesfora	b	
tella	b	
telma	b	
telsa	b	
telvia	b	
telvina	b	
temilda	b	
temilde	b	
teodicelda	b	
teodiselda	b	
teodit	b	
teodocia	b	
teodolinda	b	
teodomila	b	
teodomilaz	t	teodomila
teodomira	b	
teodora	b	
teodosia	b	
teodula	b	
teofelina	b	
teofila	b	
teofilde	b	
teogilde	b	
teoldolinda	b	
teolinda	b	
teonila	b	
teotilde	b	
teotista	b	
teotiste	b	
terersa	t	teresa
teresa	b	
teresia	t	teresa
teresinda	b	
teresita	b	
terez	t	teresa
tereza	b	
terezqa	t	tereza
tertesa	t	teresa
tesesa	t	teresa
theresa	b	
tiberia	b	
tiburcia	b	
ticia	b	
tila	b	
tilcia	b	
tilde	b	
tilia	b	
tilma	b	
tilsa	t	tilsia
tilsia	b	
tiltia	t	tilia
tilvina	b	
timatea	b	
timizay	b	
timotea	b	
tina	b	
tiodomila	b	
tiodomira	b	
tiolinda	b	
tiomatilde	b	
tirsa	b	
tirza	b	
tised	t	lised
tita	b	
titha	b	
tiufilde	t	teofilde
tolanda	t	yolanda
tolima	b	
tomasa	b	
tony	b	
torivia	b	
trancito	t	transito
tranisto	t	transito
transito	b	
trasilda	b	
treicy	b	
triana	b	
trifina	b	
trina	b	
trinadad	t	trinidad
trinana	t	triana
trindad	t	trinidad
trini	b	
trinidad	b	
trinidada	t	trinidad
triny	b	
trnasito	t	transito
trnsito	t	transito
tulia	b	
tulsa	b	
ubaldin	t	ubaldina
ubaldina	b	
ubelina	b	
ubia	t	nubia
ubilema	t	ubilerma
ubilerma	b	
ubiter	b	
ucelia	b	
udalia	b	
udeilde	b	
udid	t	edid
udolinda	b	
udoxia	b	
udrey	b	
uecaris	t	eucaris
uedosia	t	eudosia
ufrocina	b	
ularia	b	
ulbina	b	
ulda	t	hilda
uldemisa	b	
uldi	b	
ulibeth	b	
ulieth	b	
ulit	b	
ulmaris	b	
ulmary	b	
ulpiana	b	
ulrike	b	
uma	b	
umalda	b	
umbelina	b	
umelida	t	melida
umelina	b	
undecimilia	b	
uniz	t	inez
uralinda	b	
urania	b	
urbana	b	
urbanid	b	
urbara	b	
ureil	t	uriel
uriel	b	
urimilda	b	
uriselva	b	
uronilda	b	
urpiana	b	
urquina	b	
ursula	b	
ursulina	b	
ursulla	t	ursula
usley	b	
ustavia	b	
uvadelvina	b	
uvaldina	b	
uvelia	b	
uvilerma	b	
uwaldina	t	uvaldina
uxelina	b	
uyanit	b	
valancia	t	valencia
valbina	b	
valdina	b	
valdramina	b	
valencia	b	
valenica	t	valencia
valentina	b	
valeria	b	
valerian	t	valeria
valetina	t	valentina
valvina	b	
vanesa	b	
vanessa	b	
vara	t	vera
veeky	b	
vegoña	b	
veiba	b	
veiva	b	
velarmina	b	
velcy	b	
veldy	b	
velen	t	belen
velia	b	
velice	b	
vellany	b	
velquis	b	
velsamina	b	
velsis	b	
velsques	t	belquis
velsus	b	
venancia	b	
venecia	b	
veneda	b	
venencia	t	valencia
veneranda	b	
veneth	b	
venicia	b	
venilda	b	
venis	b	
venit	b	
ventura	b	
venus	b	
vera	b	
verenice	b	
verenise	t	verenice
vergelina	b	
verginia	t	virginia
verita	b	
verlucy	b	
veronica	b	
versa	t	vera
vertilde	b	
vertina	b	
vetulia	t	betulia
veyda	b	
vianedy	b	
vianeth	b	
vianey	b	
vianney	b	
vianny	b	
viany	b	
vicena	b	
vicencia	b	
vicenta	b	
vicitacion	b	
vicki	b	
vicky	b	
vicneta	t	vicenta
vicsala	b	
victa	b	
victaliana	b	
victoria	b	
victoriana	b	
victorina	b	
vidalia	b	
vidalina	b	
videlia	b	
vidermina	b	
viena	b	
vilalba	t	villalba
vildeny	b	
villadina	b	
villalba	b	
villaldina	b	
villamaria	b	
villamarina	b	
villardina	b	
villava	t	villalba
vilma	b	
vina	b	
vinelba	b	
vinelda	b	
vingelina	b	
violeta	b	
virgelina	b	
virgelma	b	
virgen	b	
virgilia	b	
virgilina	b	
virgina	b	
virginia	b	
virgunia	t	virginia
virtinia	t	virginia
visitaciom	t	visitacion
visitacion	b	
visitasion	t	visitacion
vita	b	
vitalbina	b	
vitalia	b	
vitaliana	b	
vitalicia	b	
vitalina	b	
vitalvina	b	
vitel	b	
vitelba	b	
vitelbina	b	
vitelia	b	
vitelma	b	
vitelmina	b	
vitelva	b	
vitelvina	b	
viterbina	b	
viterlicia	b	
vitermina	b	
viterminia	b	
viterna	b	
vitervina	b	
vitervo	b	
vivel	b	
vivi	b	
vivia	b	
vivian	b	
viviana	b	
vivie	b	
vivien	b	
vivtoria	t	victoria
waldina	b	
walkiria	b	
walquiria	b	
wanda	b	
wbaldina	b	
wbilerma	b	
welky	b	
welvia	t	elvia
wendy	b	
wenseslada	b	
whaidy	b	
wilcen	b	
wilerma	b	
wilger	b	
wilhelmina	b	
willy	b	
wilma	b	
wilsa	b	
wisnelia	b	
wriel	t	uriel
wualdina	b	
xenia	b	
ximena	b	
xiomar	b	
xiomara	b	
yabet	b	
yaciri	b	
yackeline	b	
yacquelin	b	
yacqueline	b	
yaddy	b	
yadende	b	
yadhy	b	
yadi	b	
yadid	b	
yadila	b	
yadira	b	
yadire	b	
yadis	b	
yadisma	b	
yadit	b	
yady	b	
yadyra	b	
yahel	b	
yaicidel	b	
yaima	b	
yaime	b	
yaira	b	
yajaira	b	
yakaira	b	
yakelin	b	
yakeline	b	
yakelyn	b	
yakisia	b	
yali	b	
yalid	b	
yalider	b	
yalila	b	
yalile	b	
yalili	b	
yalilly	b	
yalily	b	
yalinde	b	
yaline	b	
yalire	b	
yalit	b	
yalyle	b	
yamaira	b	
yamel	b	
yamid	b	
yamil	b	
yamilce	b	
yamile	b	
yamileth	b	
yamilex	b	
yamily	b	
yamir	b	
yamire	b	
yamylle	t	yamile
yanci	b	
yancid	b	
yancir	b	
yanckeline	t	yackeline
yancy	b	
yandy	b	
yandys	b	
yaned	b	
yaneht	b	
yaneira	b	
yaneri	b	
yanet	b	
yaneth	b	
yanethe	b	
yanett	b	
yaney	b	
yani	b	
yanibe	b	
yaniber	b	
yanid	b	
yanida	b	
yanif	t	yanid
yanile	b	
yanilza	b	
yanin	b	
yanine	b	
yanir	b	
yanira	b	
yanire	b	
yaniris	b	
yanis	b	
yanise	b	
yanit	b	
yanith	b	
yanitt	b	
yanive	t	nayive
yanives	b	
yanixa	b	
yannet	b	
yanneth	b	
yannethe	b	
yannine	b	
yanora	b	
yanory	b	
yanteth	t	yaneth
yanuba	b	
yanube	b	
yaquelin	b	
yaquelina	b	
yaqueline	b	
yaquiline	t	yaqueline
yara	b	
yardlely	b	
yarely	b	
yarid	b	
yarides	b	
yarienna	b	
yarime	b	
yaritza	b	
yariza	b	
yarledy	b	
yarledys	b	
yarleny	b	
yarleth	b	
yarley	b	
yarlin	b	
yarly	b	
yarsely	b	
yary	b	
yaryeth	b	
yasbel	b	
yasbeth	b	
yasbleidy	b	
yasbleydy	b	
yaselly	b	
yasenia	t	yesenia
yasmary	b	
yasmid	b	
yasmila	b	
yasmile	b	
yasmili	b	
yasmin	b	
yasmina	b	
yasmine	b	
yasmira	b	
yasmit	b	
yasmith	b	
yasmyn	t	yasmin
yasnelly	b	
yasnid	b	
yatneth	t	yaneth
yavany	t	yovany
yazdime	b	
yazmila	b	
yazmin	b	
yazmina	b	
yazmine	b	
yazmith	b	
ydali	b	
ydaly	b	
ydor	b	
yeanneth	b	
yecenia	b	
yecsenia	b	
yedilfa	b	
yedith	b	
yehimy	b	
yeime	b	
yeimi	b	
yeimmy	b	
yeimy	b	
yeine	b	
yeinit	b	
yeinith	b	
yeinmy	b	
yeinny	b	
yeiny	b	
yeladir	b	
yelcira	t	elcira
yelenna	b	
yeleny	b	
yelgy	b	
yelice	b	
yelicza	b	
yelila	b	
yelili	b	
yelipza	b	
yelithza	b	
yelitza	b	
yelixa	b	
yelmira	b	
yelsi	b	
yemilge	b	
yemny	t	yenny
yenci	b	
yency	b	
yened	b	
yeneth	b	
yeni	b	
yenifer	b	
yenilser	b	
yenin	b	
yenis	b	
yenit	b	
yenith	b	
yenly	b	
yenni	b	
yenniffer	b	
yennis	b	
yenny	b	
yennyy	t	yenny
yensi	b	
yenssy	b	
yensy	b	
yeny	b	
yenyth	b	
yenzy	b	
yercy	b	
yeris	b	
yerleny	b	
yerli	b	
yerlin	b	
yerly	b	
yery	b	
yesecnia	t	yesenia
yeselin	b	
yesenia	b	
yesica	b	
yesmen	b	
yesmid	b	
yesmin	b	
yesmith	b	
yesneida	b	
yesnit	b	
yessica	b	
yeteine	b	
yeudid	b	
yeyn	b	
yeyni	b	
yezenia	b	
yezmin	t	yazmin
yhlelipza	b	
yhol	b	
yiba	b	
yibe	b	
yiber	b	
yicel	b	
yicela	b	
yicenia	b	
yider	b	
yidet	b	
yilena	b	
yili	b	
yima	b	
yime	b	
yina	b	
yince	b	
yined	b	
yinet	b	
yineth	b	
yinett	b	
yinna	b	
yinneth	b	
yinney	b	
yiosela	t	yisela
yira	b	
yiralda	b	
yirinadia	b	
yirley	b	
yirma	b	
yised	b	
yisel	b	
yisela	b	
yisenia	b	
yiseth	b	
yive	b	
yivis	b	
yizzeth	b	
ylma	b	
yoana	b	
yoanna	b	
yobana	b	
yody	b	
yofana	t	yohana
yofanni	b	
yofany	b	
yohana	b	
yohanna	b	
yohen	b	
yoissy	b	
yojana	b	
yola	b	
yolanda	b	
yolandda	t	yolanda
yolangel	b	
yolay	b	
yolby	b	
yoleida	b	
yoleima	b	
yoleny	b	
yoleth	b	
yoli	b	
yolied	b	
yolima	b	
yoliman	t	yolima
yolinda	b	
yolis	b	
yoliva	b	
yolly	b	
yolvi	b	
yoly	b	
yomaira	b	
yomaly	b	
yomar	b	
yomara	b	
yomary	b	
yoneida	b	
yoneima	b	
yonency	b	
yor	b	
yordady	b	
yordelys	b	
yoreyni	b	
yorfany	b	
yorfit	b	
yorgladis	b	
yorieth	b	
yorlady	b	
yorlandy	b	
yorledys	b	
yorlenis	b	
yorleny	b	
yorleth	b	
yorley	b	
yormaris	b	
yormary	b	
yornely	b	
yory	b	
yosberly	b	
yovana	b	
yovany	b	
yraidis	b	
yriam	t	myriam
yrlay	b	
yrly	b	
yubely	b	
yubi	b	
yubith	b	
yudi	b	
yudin	b	
yudit	b	
yudith	b	
yudix	b	
yudy	b	
yuidissi	b	
yuile	b	
yujy	b	
yulany	b	
yulet	b	
yuley	b	
yuli	b	
yulian	b	
yuliana	b	
yulie	b	
yulied	b	
yuliet	b	
yulieth	b	
yulith	b	
yulli	b	
yully	b	
yulmeis	b	
yuly	b	
yulyhet	b	
yunari	b	
yunet	b	
yuneth	b	
yuni	b	
yunith	b	
yuraly	b	
yurani	b	
yurany	b	
yurdaly	b	
yurdey	b	
yure	b	
yureidy	b	
yuri	b	
yuriberth	b	
yurid	b	
yuriet	b	
yurith	b	
yurlay	b	
yurleth	b	
yurley	b	
yurly	b	
yurminda	b	
yury	b	
yuxmary	b	
yuyis	b	
yvonne	b	
yzmey	b	
zahida	b	
zaida	b	
zaide	b	
zaidee	b	
zaidy	b	
zaira	b	
zaire	b	
zamira	b	
zanaida	t	zenaida
zandra	b	
zara	b	
zarely	b	
zarina	b	
zea	b	
zeida	b	
zeila	b	
zelene	b	
zeleny	b	
zelia	b	
zenaida	b	
zenayda	b	
zeneida	b	
zeneyda	b	
zenide	b	
zenit	b	
zenith	b	
zenobia	b	
zilia	t	cilia
zita	b	
ziva	b	
zobeida	b	
zohedma	b	
zoila	b	
zoilar	t	zoila
zoira	b	
zolainis	b	
zolia	t	zoila
zonia	b	
zora	b	
zorahida	b	
zoraida	b	
zorani	b	
zoraya	b	
zorayda	b	
zorely	b	
zoreth	b	
zory	b	
zoveida	b	
zoyla	b	
zubeida	b	
zubeyda	b	
zucely	b	
zucen	b	
zue	b	
zueri	b	
zuhe	b	
zula	b	
zulay	b	
zuleida	b	
zuleima	b	
zulema	b	
zuleny	b	
zulerma	t	zulema
zuley	b	
zuleyka	b	
zuleyma	b	
zuli	b	
zulieth	b	
zulima	b	
zulinda	b	
zully	b	
zulma	b	
zuly	b	
zunilda	b	
zuny	b	
zurelly	b	
zurima	b	
zury	b	
