aame	b	
aaza	b	
aba	b	
abad	b	
abadia	b	
abahunza	b	
abanceza	b	
abando	b	
abanza	b	
abaunja	b	
abaunza	b	
abauza	b	
abdenago	b	
abella	b	
abellaneda	b	
abello	b	
abendaño	b	
abhunza	t	abahunza
abil	b	
abirl	t	abril
abnril	t	abril
abohorquez	t	bohorquez
abondano	b	
aborashed	b	
abregon	b	
abreo	b	
abreu	b	
abrez	b	
abril	b	
abrilq	t	abril
abriñ	t	abril
abrl	t	abril
abuabara	b	
abuassi	b	
acbarracin	t	albarracin
acebedo	b	
acebes	b	
acelas	b	
aceldas	b	
acellaneda	t	avellaneda
acena	b	
acencio	b	
acera	b	
acero	b	
acerom	t	acero
aceros	b	
acevado	b	
acevdo	t	acevedo
aceveda	b	
acevedi	t	acevedo
acevedo	b	
acevedor	t	acevedo
acevedso	t	acevedo
aceves	b	
aceveso	t	acevedo
achagua	b	
achaguer	b	
acheverri	b	
acheverria	b	
achgua	t	achagua
achicanoy	b	
achkar	b	
achoa	b	
achogua	t	achagua
achur	b	
achure	b	
achuri	b	
achury	b	
acila	b	
acoba	b	
aconcha	b	
acosta	b	
acostra	t	acosta
acota	t	acosta
acrdozp	t	cardozo
acro	b	
acrranza	t	carranza
acruz	b	
acuarado	b	
acuesta	b	
acuevas	t	cuevas
acuna	b	
acuña	b	
adama	b	
adame	b	
adams	b	
adan	b	
adans	b	
adarbe	b	
adarme	b	
adarraga	b	
adarve	b	
adilla	b	
adome	b	
aeguello	t	arguello
aeljandro	t	alejandro
aenz	t	saenz
aeocha	t	arocha
aevalo	t	arevalo
aevedo	t	acevedo
afanador	b	
afara	b	
afaro	b	
aflonso	t	alfonso
africani	b	
africano	b	
africany	b	
agamez	b	
aganome	b	
agarita	t	angarita
agarra	b	
agaton	b	
agfricano	t	africano
agiaco	b	
agilar	t	aguilar
agirre	t	aguirre
agrado	b	
agragua	b	
agredo	b	
agresort	b	
aguablanca	b	
aguas	b	
aguasaco	b	
aguazaco	b	
aguazoco	b	
aguazuco	b	
agudeelo	t	agudelo
agudela	b	
agudello	t	agudelo
agudelo	b	
agueda	b	
aguello	t	arguello
aguepo	b	
aguera	t	agueda
aguero	b	
aguerri	b	
aguialr	t	aguilar
aguierre	t	aguirre
aguila	b	
aguilar	b	
aguilera	b	
aguillar	b	
aguillon	b	
aguire	b	
aguirre	b	
aguirree	t	aguirre
aguirrre	t	aguirre
aguja	b	
agular	b	
agulera	t	aguilera
aguliar	t	aguilar
agullion	t	aguillon
agunaga	b	
agurre	t	aguirre
ahes	b	
ahumada	b	
aillon	b	
airas	t	arias
airias	t	arias
aisalez	b	
aislant	b	
aissa	b	
aitza	b	
aizales	b	
aizama	b	
ajeda	b	
ajiaco	b	
alaba	t	alba
alacantar	b	
aladino	b	
alaix	b	
alajandro	t	alejandro
alalrcon	t	alarcon
alameda	b	
alana	b	
alape	b	
alar	b	
alaracon	t	alarcon
alarccon	t	alarcon
alarco	t	alarcon
alarcom	t	alarcon
alarcon	b	
alarik	b	
alarion	b	
alarte	b	
alavarado	b	
alavardo	b	
alavarez	t	alvarez
alavbarracin	t	albarracin
alaya	b	
alayan	b	
alayon	b	
alba	b	
albaciano	b	
albadan	b	
albaerto	t	alberto
albag	b	
alban	b	
albana	b	
albañil	b	
albanzo	b	
albaracion	t	albarracin
albarado	b	
albaran	b	
albararcion	t	albarracin
albarez	b	
albarraciin	t	albarracin
albarracil	t	albarracin
albarracin	b	
albarracing	t	albarracin
albarracion	b	
albarran	b	
albarrasil	t	albarracin
albarricin	t	albarracin
albarrracin	t	albarracin
albbarracin	t	albarracin
albear	b	
albeciano	b	
albereto	t	alberto
albero	t	alberto
alberto	b	
albertol	t	alberto
albertoo	t	alberto
albertro	t	alberto
albertto	t	alberto
albesiano	b	
albeto	t	alberto
albino	b	
albo	b	
albores	b	
albornos	b	
albornoz	b	
albrerto	t	alberto
albrracin	t	albarracin
albrto	t	alberto
alcachofe	b	
alcala	b	
alcantar	b	
alcantara	b	
alcaraz	b	
alcarraza	b	
alcazar	b	
alcina	b	
alcira	b	
alcitra	t	alcira
alcocer	b	
aldana	b	
aldarra	b	
aldaz	b	
aldna	t	aldana
aldonso	t	alfonso
alean	b	
aleberto	t	alberto
alebrto	t	alberto
alegre	b	
alegria	b	
alegrias	b	
alejandfro	t	alejandro
alejando	t	alejandro
alejandro	b	
alejendro	t	alejandro
alejgando	t	alejandro
alejo	b	
aleman	b	
alenajdro	t	alejandro
alencia	b	
alendro	b	
alercon	t	alarcon
alero	b	
alevedro	b	
alezones	b	
alfanso	t	alfonso
alfarao	b	
alfaro	b	
alfasat	b	
alferes	b	
alferez	b	
alfinso	t	alfonso
alfnso	t	alfonso
alfomso	t	alfonso
alfondo	t	alfonso
alfono	t	alfonso
alfonso	b	
alfonzo	b	
alfopnso	t	alfonso
alforia	b	
alfosno	t	alfonso
alfoso	b	
alfrusa	b	
algarin	b	
algarra	b	
algeciras	b	
algel	t	angel
algonso	t	alfonso
alicastro	b	
alioscha	b	
alipio	b	
alizalde	b	
allala	b	
allfonso	t	alfonso
almagro	b	
almanacid	b	
almanza	b	
almanzar	b	
almazar	b	
almeciga	b	
almedo	b	
almeida	b	
almendrales	b	
almenjo	b	
almestica	b	
almeyda	b	
almonaci	b	
almonacid	b	
alnfonso	t	alfonso
alnfoso	t	alfonso
alonsa	b	
alonsi	b	
alonso	b	
alonson	b	
alonzo	b	
alosno	t	alonso
alpargatero	b	
alparra	b	
alrcon	t	alarcon
alrjandro	t	alejandro
alrrutia	b	
alrturo	t	arturo
altamar	b	
alturo	b	
altuzana	b	
altuzarra	b	
altuzarro	b	
alva	b	
alvaarado	t	alvarado
alvada	b	
alvadado	t	alvarado
alvado	b	
alvaerz	t	alvarez
alvaez	t	alvarez
alvantar	b	
alvaraado	t	alvarado
alvaradao	b	
alvaraddo	t	alvarado
alvaradi	t	alvarado
alvarado	b	
alvaraez	t	alvarez
alvarao	b	
alvararez	t	alvarez
alvardado	t	alvarado
alvardo	b	
alvares	b	
alvarez	b	
alvarino	b	
alvear	b	
alverez	b	
alviades	b	
alviarez	t	alvarez
alvio	b	
alvira	b	
alvis	b	
alvrado	t	alvarado
alvrez	t	alvarez
alza	b	
alzate	b	
alzona	b	
alzugarate	b	
amado	b	
amador	b	
amaga	b	
amaguaña	b	
amague	b	
amaldonado	t	maldonado
amar	b	
amara	b	
amaria	t	maria
amariles	b	
amarillo	b	
amaris	b	
amariz	b	
amature	b	
amay	b	
amaya	b	
amazo	b	
ambuila	b	
amdrade	t	andrade
amelines	b	
amelinez	b	
amendaño	b	
amenquita	t	amezquita
amesquita	b	
amezauita	t	amezquita
amezquita	b	
amezquta	t	amezquita
ammann	b	
ammar	b	
amon	b	
amor	b	
amore	b	
amorocho	b	
amortegui	b	
amota	b	
amoya	b	
ampudia	b	
amria	t	maria
amrtin	t	martin
amrtinez	t	martinez
amu	b	
amya	b	
amyn	b	
amyuer	b	
anacarsel	b	
anacona	b	
anagarita	b	
anagel	t	angel
anajar	b	
anama	b	
ananjar	b	
anave	b	
anaya	b	
anchez	t	sanchez
anchique	b	
anchogua	b	
ancin	b	
andara	b	
andel	b	
andona	b	
andoval	t	sandoval
andrade	b	
andrda	t	andrade
anduquia	b	
anear	b	
angal	t	angel
angaria	t	angarita
angarita	b	
angartia	t	angarita
angaruta	t	angarita
ange	b	
angek	t	angel
angel	b	
angola	b	
angrita	t	angarita
angulo	b	
angwel	t	angel
anija	b	
animero	b	
anrique	t	enrique
ante	b	
antero	b	
antibar	b	
antipara	b	
antoline	b	
antolines	b	
antolinez	b	
antonid	b	
antonilez	b	
anual	b	
anza	b	
anzola	b	
anzonla	t	anzola
anzuata	b	
anzuela	b	
anzueta	b	
anzuta	b	
aocsta	t	acosta
aofonso	t	alfonso
aolonso	t	alonso
apache	b	
apacio	b	
apanza	b	
apariacio	t	aparicio
apariciio	t	aparicio
aparicio	b	
apayome	b	
aperador	b	
apetos	b	
apiara	b	
apnte	t	aponte
apolinar	b	
apolnar	t	apolinar
aponste	t	aponte
aponte	b	
apontes	b	
apopnte	t	aponte
apornte	t	aponte
apoyame	t	apoyome
apoyome	b	
apraez	b	
apuleyo	b	
aquevedo	t	quevedo
aquiar	b	
aquino	b	
aquirre	t	aguirre
aquite	b	
aquiz	b	
aqvila	t	avila
aracica	b	
aragon	b	
aragones	b	
araguren	b	
arais	b	
arama	b	
aramando	t	armando
arambar	b	
arambula	b	
arambulo	b	
arana	b	
aranbula	t	arambula
aranda	b	
arande	t	aranda
arandia	b	
arango	b	
arangon	b	
arangure	b	
aranguren	b	
aranjuez	b	
aranque	b	
aranzales	b	
aranzazu	b	
araque	b	
ararat	b	
arateca	b	
arateco	b	
araujo	b	
arauqe	t	araque
aravalo	t	arevalo
arazan	b	
arazo	b	
arbelaez	b	
arboleda	b	
arcaraz	b	
arce	b	
archica	b	
archil	b	
archila	b	
archilas	b	
archile	b	
archilla	b	
arcia	t	garcia
arcila	b	
arcilia	b	
arcilla	b	
arciniegas	b	
arco	b	
arcon	b	
arcos	b	
arcualo	b	
arddila	t	ardila
ardila	b	
ardilla	b	
arebalo	b	
aredo	b	
areiza	b	
arellano	b	
aremila	b	
arena	b	
arenal	b	
arenales	b	
arenas	b	
arenasl	b	
arencelo	b	
arengas	b	
arero	b	
arevalaos	t	arevalos
arevalo	b	
arevalos	b	
arevelo	t	arevalo
arfan	b	
argangel	b	
argello	t	arguello
argolla	b	
arguelles	b	
arguellez	b	
arguello	b	
arguerllo	t	arguello
argullo	t	arguello
aria	b	
arias	b	
ariaz	b	
aricaipa	b	
aricapa	b	
aricara	b	
aries	b	
arieto	b	
ariña	b	
aris	b	
arismedi	b	
arismedy	b	
arismende	b	
arismendi	b	
arismendis	b	
arismendy	b	
arismnedi	t	arismendi
aristisabal	t	aristizabal
aristizaabal	t	aristizabal
aristizabal	b	
aristizal	b	
aristzabal	t	aristizabal
ariza	b	
arizala	b	
arizmende	t	arismendi
arizmendy	b	
ariztizabal	t	aristizabal
arjemiro	b	
arjona	b	
arma	b	
armanado	t	armando
armand	b	
armando	b	
armanro	t	armando
armanza	b	
armas	b	
armendo	t	armando
armenta	b	
armero	b	
armesto	b	
armirola	b	
arnando	t	armando
arnau	b	
arnica	b	
aroca	b	
arocha	b	
arogon	b	
aroila	b	
arosa	b	
arosas	b	
arozco	t	orozco
arque	b	
arquimedez	b	
arrazola	b	
arreaga	b	
arreaza	b	
arredondo	b	
arregui	b	
arrendondo	b	
arreola	b	
arrera	b	
arriaga	b	
arrieta	b	
arrigui	b	
arriola	b	
arrita	b	
arroyabe	b	
arroyano	b	
arroyave	b	
arroyo	b	
arrubla	b	
arselas	b	
arsiniegas	t	arciniegas
arsusa	b	
arta	t	martha
artavia	b	
arteaga	b	
artehaga	b	
artinez	b	
artiz	t	ortiz
artroza	b	
artturo	t	arturo
artuluaga	b	
artunduaca	t	artunduaga
artunduaga	b	
arturo	b	
artutro	t	arturo
aruturo	t	arturo
arvajal	t	carvajal
arvelaez	t	arbelaez
arvis	b	
arzuaga	b	
arzuza	b	
asacatiqui	b	
asanchez	t	sanchez
asbulo	b	
ascanio	b	
ascencio	b	
ascencion	b	
ascensio	b	
ascrnsio	t	ascensio
asencio	b	
aseucio	b	
asevedo	t	acevedo
asmezquita	t	amezquita
asnabria	t	sanabria
asprila	b	
asprilla	b	
assa	b	
assmus	b	
astaiza	b	
astamorir	b	
astillo	b	
astro	b	
astros	b	
astrosa	b	
astroz	b	
astroza	b	
atapuma	b	
atara	b	
atare	b	
atehortua	b	
atencia	b	
atencio	b	
atheortua	b	
atilla	b	
atilu	t	atilua
atilua	b	
atilva	b	
atiño	t	patino
atoche	b	
atora	b	
atuerto	b	
atuesta	b	
atuestas	b	
atuesto	b	
atusta	b	
auala	t	ayala
aucencio	b	
auchter	b	
audiverth	b	
auila	t	avila
aulestia	b	
aumta	b	
auña	t	acuna
aunta	b	
ausaque	b	
ausique	b	
ausla	b	
auzaque	b	
avalla	b	
avalle	b	
avalleneda	t	avellaneda
avalo	b	
avalos	b	
avando	b	
avanzada	b	
avarado	t	alvarado
avarez	t	alvarez
avaunza	b	
avecedo	t	acevedo
avejero	b	
avella	b	
avelladena	b	
avellanada	t	avellaneda
avellanda	t	avellaneda
avellandea	t	avellaneda
avellandeda	t	avellaneda
avellaneda	b	
avelleneda	t	avellaneda
avellla	t	avella
avellneda	t	avellaneda
avello	b	
avenda	b	
avendaño	b	
avendaños	b	
averjas	b	
avertas	b	
avevedo	t	acevedo
avial	b	
aviala	b	
avigail	b	
avila	b	
avilan	b	
avilana	b	
aviles	b	
avilez	b	
avillaneda	t	avellaneda
avillon	b	
avival	b	
avla	t	avila
avllaneda	t	avellaneda
awazacko	b	
aya	b	
ayaca	b	
ayala	b	
ayalas	t	ayala
ayalsa	t	ayala
ayaña	t	ayala
ayerbe	b	
ayure	b	
aza	b	
azaf	b	
azlonso	t	alonso
azuay	b	
azuero	b	
azula	b	
azuma	b	
baarera	t	barrera
baarragan	t	barragan
baba	b	
babativa	b	
baca	b	
bacares	b	
bacarez	b	
bacca	b	
bacci	b	
bacerra	t	becerra
bacerrra	t	becerra
bachelot	b	
bachiller	b	
bader	b	
badillo	b	
badominac	t	badovinac
badovinac	b	
badovinal	b	
baena	b	
baenz	b	
baerz	b	
baez	b	
baguen	b	
baguero	t	baquero
bahaman	b	
bahamon	b	
bahena	b	
bahos	b	
bailon	b	
baitilla	b	
baito	b	
bajarano	t	bejarano
bajica	b	
baken	b	
balagera	t	balaguera
balaguera	b	
balagura	b	
balamba	b	
balanca	t	blanca
balanguera	t	balaguera
balanta	b	
balaquera	b	
balata	b	
balba	t	alba
balbanera	b	
balbin	b	
balbuena	b	
balcacer	b	
balcarcel	b	
balcazar	b	
balcazer	b	
balceras	b	
balcero	b	
balceros	b	
baldeon	b	
balderrama	t	valderrama
baldian	b	
baldion	b	
balero	b	
balesteros	t	ballesteros
baleta	b	
balisario	b	
balka	b	
balla	b	
balladarez	b	
ballares	b	
ballejo	t	vallejo
ballen	b	
balles	b	
ballesteos	t	ballesteros
ballestero	t	ballesteros
ballesterods	t	ballesteros
ballesteros	b	
ballona	b	
balmaceda	b	
balnca	t	blanca
balnco	t	blanco
balsero	b	
balseros	b	
balsora	b	
balta	b	
balvin	b	
balvuena	b	
bamba	b	
bamboa	b	
bamona	b	
bana	b	
banavides	t	benavides
banavidez	t	benavides
banca	t	blanca
banda	b	
bandera	b	
banderas	b	
bandurraga	b	
banguero	b	
banitez	t	benitez
bañol	b	
banos	b	
banquera	b	
baoada	t	boada
baoya	b	
baoyona	t	bayona
baptista	b	
baptiste	b	
baquen	b	
baquera	b	
baquero	b	
baqueron	b	
baquiro	b	
baracaldo	b	
baraceta	b	
baragan	t	barragan
barahana	t	barahona
barahona	b	
baraja	b	
barajas	b	
barajs	t	barajas
baran	b	
baranoa	b	
baranova	b	
baranza	b	
baraona	b	
baray	b	
barazeta	b	
barbaran	b	
barbosa	b	
barcarcel	b	
barcenas	b	
barchilan	b	
barchillon	t	barchilon
barchilon	b	
barcias	b	
barco	b	
barda	b	
barela	b	
bareño	b	
barera	b	
barerra	t	barrera
bareto	t	barreto
barin	t	baron
barina	b	
barinas	b	
barker	b	
barnier	b	
barnosa	t	barbosa
barohona	t	barahona
baron	b	
barona	b	
baronana	t	barona
baronb	t	baron
barragan	b	
barragn	t	barragan
barragoa	b	
barrallo	b	
barrante	b	
barrantes	b	
barranza	b	
barrara	b	
barrato	t	barreto
barray	b	
barraza	b	
barrea	t	barrera
barreara	t	barrera
barreba	b	
barreera	t	barrera
barreiro	b	
barreneche	b	
barreno	b	
barreño	b	
barrer	t	barrera
barrera	b	
barreras	b	
barrero	b	
barreros	b	
barrerto	t	barreto
barreta	t	barrera
barreto	b	
barretro	t	barreto
barrgan	t	barragan
barrientos	b	
barriga	b	
barriios	t	barrios
barrios	b	
barrobo	b	
barros	b	
barroso	b	
barrote	b	
barroto	b	
barrrera	t	barrera
barrteo	t	barreto
barrueto	t	barreto
barz	b	
barzaga	b	
basaldo	b	
basallo	b	
basayo	b	
basilota	b	
basilotta	b	
basquez	t	vasquez
bastan	b	
bastgilla	t	bastilla
bastidas	b	
bastilla	b	
bastillas	b	
basto	b	
bastos	b	
basurto	b	
bata	b	
batanero	b	
batativa	b	
bateca	b	
batema	b	
batilla	b	
batista	b	
baton	b	
batta	b	
battista	b	
bauatista	t	bautista
baudichon	b	
baudillo	b	
baudista	b	
bauitista	t	bautista
bauitosta	t	bautista
baumuller	b	
baunza	b	
baustista	t	bautista
bautisat	t	bautista
bautisata	b	
bautista	b	
bautistaq	t	bautista
bautistya	t	bautista
bautiza	b	
bautizta	t	bautista
bay	b	
baya	b	
bayaca	t	boyaca
bayana	b	
bayares	b	
bayer	b	
bayesteros	b	
bayo	b	
bayon	b	
bayona	b	
bayora	b	
bayota	b	
bayoya	b	
bayter	b	
bazurdo	b	
bazurto	b	
bbuitrgo	t	buitrago
beaimy	b	
beaz	t	baez
becarra	t	becerra
beccera	t	becerra
beccerra	t	becerra
becera	t	becerra
becerra	b	
becerrra	t	becerra
becquet	b	
becrra	t	becerra
bedcerra	t	becerra
bedeu	b	
bedoya	b	
bedoyo	t	bedoya
bedpya	t	bedoya
bedregal	b	
beetar	b	
beil	b	
beintez	t	benitez
beitar	b	
bejaramo	t	bejarano
bejarano	b	
bejarrano	t	bejarano
belalcazar	b	
belarcazar	t	belalcazar
belcimon	b	
beleno	b	
beleño	b	
belerra	b	
belisario	b	
beliz	b	
belizario	t	belisario
bellano	b	
bellicia	b	
belliza	b	
bellizia	b	
bello	b	
bellon	b	
belloso	b	
bellota	b	
belmonte	b	
beltan	t	beltran
beltra	t	beltran
beltran	b	
beltraqn	t	beltran
beltrl	t	beltran
beltrn	t	beltran
benabides	t	benavides
benal	t	bernal
benavidas	t	benavides
benavide	t	benavides
benavides	b	
benavidez	b	
benbtacur	t	betancur
benedetti	b	
benevides	t	benavides
benevidez	t	benavides
beniitez	t	benitez
benires	b	
benirez	t	benitez
benitas	t	benitez
benite	t	benitez
benites	b	
benitex	t	benitez
benitez	b	
benitz	t	benitez
benivides	t	benavides
benjumea	b	
bensiman	b	
bentacour	t	betancour
bentacourt	b	
bentacourth	b	
bentancour	b	
bentancur	b	
bentitez	t	benitez
bentran	t	beltran
bentura	t	ventura
benvides	t	benavides
beranl	t	bernal
berano	b	
berbeo	b	
berbesi	b	
berbesy	b	
berbosa	t	barbosa
bercedo	b	
bercerra	t	becerra
berchilon	b	
berdudo	t	berdugo
berduen	b	
berdugo	b	
berend	b	
bergano	b	
bergaño	b	
bergara	t	vergara
berjel	t	vergel
berkeley	b	
bermeja	t	bermejo
bermejo	b	
bermeo	b	
bermeso	b	
bermidez	t	bermudez
bermnal	t	bernal
bermudes	t	bermudez
bermudez	b	
bermuez	t	bermudez
bermundez	t	bermudez
berna	t	bernal
bernal	b	
bernan	t	bernal
bernandino	b	
bernat	b	
bernate	b	
bernaz	b	
bernel	t	bernal
berno	b	
bernudez	t	bermudez
berragan	b	
berral	b	
berrara	b	
berraterano	b	
berrera	t	barrera
berreto	t	barreto
berriio	t	berrio
berrio	b	
berrios	t	barrios
berriteran	b	
berrocal	b	
berrogeran	t	berroteran
berroteran	b	
berroterano	t	berroteran
berroteras	t	berroteran
bersinger	b	
bertel	b	
bertilde	b	
beserra	t	becerra
bestel	b	
betaba	b	
betacourt	t	betancourt
betacurt	t	betancurt
betagur	b	
betanchr	t	betancur
betancohur	t	betancour
betancort	t	betancurt
betancour	b	
betancourt	b	
betancourth	b	
betancuor	b	
betancuorth	t	betancourth
betancur	b	
betancurt	b	
betancurth	b	
betancuurt	t	betancurt
betarcourt	t	betancourt
betarcourth	t	betancourth
betarncour	t	betancour
beteca	b	
betencurt	t	betancurt
bether	b	
betin	b	
betitez	t	benitez
beto	b	
betran	t	beltran
better	b	
betul	b	
beyer	b	
beyerl	t	beyer
bez	t	baez
bhorquez	t	bohorquez
bhuerfano	t	huerfano
biajan	b	
biancha	b	
biancho	b	
bianco	b	
biatiga	b	
bienco	b	
bigamil	b	
bigoth	b	
bijan	b	
bilbano	b	
bilbao	b	
billermo	b	
bilvao	b	
bina	b	
binchira	b	
binilla	b	
binitez	b	
biondi	b	
birchenall	b	
birguez	b	
bisigas	t	bosigas
bitrago	b	
blaca	t	blanca
blaco	b	
blaguera	b	
blain	b	
blana	t	blanca
blanaca	t	blanca
blanca	b	
blanco	b	
blandon	b	
blanjca	t	blanca
blannco	t	blanco
blanoc	t	blanco
blanquiset	b	
blasson	b	
bleier	b	
bleno	b	
blnac	t	blanca
blnca	t	blanca
blnco	t	blanco
blum	b	
blun	t	blum
bnarrera	t	barrera
bo	b	
boacarez	t	bacarez
boada	b	
bobadilla	b	
bobelo	b	
boboya	b	
bocachica	b	
bocanegra	b	
bocarejo	b	
bocarez	b	
bocca	b	
bocconello	b	
bochachica	b	
bochica	b	
bociga	b	
bocigas	b	
bock	b	
bocota	b	
bodensierk	b	
bodiga	b	
bodoya	t	bedoya
boes	b	
bogolla	b	
bogota	b	
bogoya	b	
bohada	b	
bohadilla	b	
bohirquez	t	bohorquez
bohoorquez	t	bohorquez
bohorequez	t	bohorquez
bohorque	t	bohorquez
bohorques	b	
bohorquez	b	
bohorquwz	t	bohorquez
bohorquyez	t	bohorquez
bohorquz	t	bohorquez
bohoruez	t	bohorquez
bojaca	b	
bolaño	b	
bolaños	b	
bolibar	b	
bolilla	b	
bolivar	b	
bolivara	t	bolivar
boloivar	t	bolivar
bombieda	b	
bombiela	b	
bombita	b	
bomnilla	t	bonilla
bona	b	
bonemo	b	
bonet	b	
bonett	b	
bonil	b	
bonilla	b	
boniloacio	b	
boniulla	t	bonilla
bonnet	b	
bonolla	t	bonilla
bonomelli	b	
bonsa	b	
bonz	t	bonza
bonza	b	
bora	b	
borales	t	morales
borbon	b	
borchilan	b	
borda	b	
bordamalo	b	
bordar	b	
bordon	b	
borey	b	
borga	t	borja
borilla	b	
borja	b	
borjas	t	borja
bormejo	t	bermejo
bornacelli	b	
borner	b	
borquez	t	bohorquez
borraez	t	borrais
borrais	b	
borrantes	t	barrantes
borras	b	
borrego	b	
borrero	b	
borucuara	b	
bosa	b	
bosica	t	bosiga
bosiga	b	
bosigas	b	
bosquez	b	
bossa	b	
bossio	b	
bostilla	t	bastilla
botache	b	
botelio	t	botello
botella	b	
botello	b	
botera	t	botero
botero	b	
boterom	b	
bothia	b	
botia	b	
botias	t	botia
botina	b	
botta	t	bottia
bottia	b	
bouillet	b	
bourdon	b	
bovelo	b	
bowen	b	
boyac	t	boyaca
boyaca	b	
boyacac	t	boyaca
boyona	t	bayona
boza	b	
bozo	b	
bracaldo	t	baracaldo
bracamonte	b	
bracidas	b	
brahan	b	
braidy	b	
brajas	b	
bram	b	
bran	b	
brana	t	bran
brand	b	
brandaner	b	
brando	b	
brango	t	brando
brauben	b	
braucin	b	
brausin	b	
bravo	b	
brcerra	t	becerra
breñez	b	
brevo	b	
breyes	b	
briceño	b	
brigad	b	
brigaldo	b	
brijalba	b	
brijalbo	t	brijaldo
brijaldbo	t	brijaldo
brijaldo	b	
brijando	t	brijaldo
bril	t	abril
brinchery	b	
brinez	b	
briñez	b	
brisalva	b	
brisneda	b	
brito	b	
britto	b	
brnal	t	bernal
broc	b	
brochero	b	
broncoso	b	
brrera	t	barrera
bruges	b	
bruitrago	t	buitrago
brum	b	
brunhart	b	
bsautista	t	bautista
buanaventura	t	buenaventura
buatamante	t	bustamante
buatista	t	bautista
bubetz	b	
bubuy	b	
buch	b	
buchabay	b	
buchely	b	
bucuru	b	
budo	b	
buelvas	b	
buenabentura	t	buenaventura
buenahora	b	
buenaventura	b	
buenaver	b	
buenberguer	b	
buendia	b	
bueno	b	
buenventura	t	buenaventura
buesaquillo	b	
buices	b	
buietrago	t	buitrago
buiitrago	t	buitrago
builes	b	
buirago	t	buitrago
buitgrago	t	buitrago
buitrafo	t	buitrago
buitrag	t	buitrago
buitraga	t	buitrago
buitragfa	t	buitrago
buitragfo	t	buitrago
buitraggo	t	buitrago
buitragio	t	buitrago
buitrago	b	
buitragop	t	buitrago
buitrajo	t	buitrago
buitraqgo	t	buitrago
buitrato	t	buitrago
buitrgo	t	buitrago
buitron	b	
buittrago	t	buitrago
bula	b	
bulia	b	
bulicie	b	
bulla	b	
burbano	b	
burgoa	t	burgos
burgos	b	
burgosa	t	burgos
buritaca	t	buritica
buritica	b	
burta	b	
burtado	t	hurtado
busa	b	
busbanza	b	
busgamen	b	
businqui	b	
bustacara	b	
bustamante	b	
bustamente	t	bustamante
bustillo	b	
busto	b	
buston	t	busto
bustos	b	
bustosa	t	bustos
busuk	b	
busuy	b	
butierrez	t	gutierrez
butrago	t	buitrago
buuitrago	t	buitrago
buya	b	
bvega	t	vega
caaballero	t	caballero
caamano	t	camano
caarvajalino	t	carvajalino
caavid	t	cadavid
caba	b	
cabal	b	
cabaler	b	
caballazzi	b	
caballero	b	
caballlero	t	caballero
caballos	b	
cabalo	b	
cabana	b	
cabanillas	b	
cabanso	t	cabanzo
cabanza	t	cabanzo
cabanzo	b	
cabarcas	b	
cabare	b	
cabarte	b	
cabas	b	
cabayero	b	
cabbra	t	cabra
cabellero	t	caballero
cabelo	b	
cabeza	b	
cabezas	b	
cabiales	b	
cabiativa	b	
cabiedes	t	caviedes
cabieles	b	
cabirrian	b	
cabirrion	b	
cabo	b	
cabra	b	
cabral	b	
cabrales	b	
cabrejo	b	
cabrera	b	
cabrero	b	
cabrra	t	cabra
cabullo	t	cabulo
cabulo	b	
caburucu	b	
cabuya	b	
caceres	b	
caceress	t	caceres
cacerez	b	
caceros	b	
cacers	t	caceres
cachai	b	
cacharna	b	
cachay	b	
cachiguango	b	
cachope	b	
cacinero	t	cocinero
cacres	t	caceres
cacua	b	
cadavid	b	
cadena	b	
cadenas	b	
cadeno	b	
cadozo	t	cardozo
caedenas	t	cardenas
caedozo	t	cardozo
caelos	t	carlos
caez	t	baez
caferino	b	
cagua	b	
cagueñas	b	
cahaparro	t	chaparro
cahaque	b	
cahope	b	
cahueco	b	
cahueñas	b	
cahueño	b	
cahusac	b	
cahverra	t	chaverra
cahvez	t	chavez
caiceddo	t	caicedo
caicedo	b	
caidedo	t	caicedo
caile	b	
caina	b	
cainaba	b	
cainabas	t	cainaba
cainava	t	cainaba
caipa	b	
caipe	b	
cairo	b	
caisedo	t	caicedo
cajamarca	b	
cajar	b	
cajica	b	
cajigas	b	
cala	b	
calambas	b	
calas	b	
calasan	b	
calasans	b	
calazan	b	
calbera	b	
calbuena	b	
caldan	b	
caldas	b	
caldenas	t	cardenas
caldera	b	
caldereon	t	calderon
caldero	b	
calderon	b	
caldes	t	valdes
caldeton	t	calderon
caldez	t	valdes
caldos	b	
calducho	b	
caleno	b	
calera	b	
caleras	b	
calero	b	
calica	b	
califa	b	
caliman	b	
calixco	b	
calixro	b	
calixto	b	
caliz	b	
callajas	t	callejas
calle	b	
calleja	b	
callejas	b	
calleno	b	
calles	b	
calletano	b	
callo	b	
calnilla	b	
calos	t	carlos
calrlos	t	carlos
calvache	b	
calver	b	
calvera	b	
calvijo	t	clavijo
calvo	b	
caly	b	
camac	b	
camacho	b	
camachoo	t	camacho
camachor	t	camacho
camaetio	b	
camago	t	camargo
camahco	t	camacho
camaho	t	camacho
camamrgo	t	camargo
camano	b	
camaño	b	
camanza	b	
camarco	t	camargo
camardo	t	camargo
camarga	t	camargo
camargao	t	camargo
camargho	t	camargo
camargo	b	
camaria	b	
camaron	b	
camayo	b	
cambero	b	
camberos	b	
cambito	b	
cambreros	t	camberos
camcho	t	camacho
came	b	
camejo	b	
camelo	b	
camelon	b	
camen	t	carmen
camera	t	camero
camero	b	
camezaquira	b	
camillo	b	
camino	b	
cammacho	t	camacho
camo	t	campo
camoargo	t	camargo
camos	b	
campaz	b	
campbell	b	
campero	b	
camperos	b	
campillo	b	
campiña	b	
campiño	b	
campo	b	
campoalegre	b	
campos	b	
campuzano	b	
camrago	t	camargo
camrgo	t	camargo
camuan	b	
can	t	cano
cana	b	
caña	b	
canacue	b	
cañadulce	b	
canal	b	
canals	t	canal
canara	b	
canaria	b	
cañas	b	
canastros	b	
cañaveral	b	
canay	b	
canbrera	t	cabrera
cancelada	b	
cancelado	b	
cancelao	t	cancelado
canchon	b	
cancino	b	
candamil	b	
candela	b	
candelo	b	
candi	t	candia
candia	b	
candiad	t	candia
canelo	b	
canesteros	b	
cango	b	
cangrejo	b	
cañizales	b	
cañizalez	b	
cañizares	b	
cañlderon	t	calderon
cano	b	
canol	t	canon
canola	b	
cañola	b	
canom	t	canon
canon	b	
canoy	b	
canpo	t	campo
canria	b	
cante	b	
canteras	b	
cantero	b	
canteros	b	
cantillo	b	
canto	b	
cantoñi	b	
cantor	b	
cañuela	b	
canuto	b	
capa	b	
capacho	b	
capachos	b	
capador	b	
capare	b	
capasachoa	b	
capeda	t	cepeda
capela	b	
capello	b	
capera	b	
capillo	b	
capo	b	
capote	b	
caqrmen	t	carmen
caqueza	b	
car	b	
cara	b	
carabal	b	
carabali	b	
caraballo	b	
carabaly	b	
carabante	b	
carabuena	b	
carabueno	b	
caracas	b	
caradenas	t	cardenas
carantoan	t	caranton
caranton	b	
carantonio	b	
carauche	b	
caravajal	t	carvajal
caravali	b	
caravante	b	
caray	b	
carbajal	b	
carbanzo	b	
carbe	b	
carbonel	b	
carbonell	b	
carbrera	t	cabrera
carcamo	b	
carchana	b	
carcia	t	garcia
carddenas	t	cardenas
cardeans	t	cardenas
cardebnas	t	cardenas
cardehnas	t	cardenas
cardemas	t	cardenas
carden	t	cardenas
cardena	b	
cardenal	b	
cardenas	b	
cardeñas	t	cardenas
cardenass	t	cardenas
cardenaz	t	cardenas
cardens	t	cardenas
cardernas	t	cardenas
cardero	b	
cardes	b	
cardiozo	t	cardozo
cardo	b	
cardoba	t	cordoba
cardon	b	
cardona	b	
cardoso	b	
cardoza	b	
cardozao	t	cardozo
cardozo	b	
cardozoz	t	cardozo
carelos	t	carlos
carenas	t	cardenas
carera	t	carrera
carero	b	
cargia	t	garcia
cargo	b	
cari	b	
caribana	b	
carillo	b	
cariza	b	
carjanal	t	carvajal
carlier	b	
carling	b	
carlnos	t	carlos
carlo	t	carlos
carloa	t	carlos
carlos	b	
carlosd	t	carlos
carlosm	t	carlos
carloss	t	carlos
carls	t	carlos
carlso	t	carlos
carman	t	carmen
carmargo	t	camargo
carme	t	carmen
carmem	t	carmen
carmen	b	
carmenb	t	carmen
carmiño	b	
carmne	t	carmen
carmnen	t	carmen
carmona	b	
carnas	b	
carnica	b	
carnicar	t	carnica
caro	b	
caroenas	t	cardenas
caroj	t	caro
caroli	b	
caroll	b	
carolli	b	
carolos	t	carlos
caron	b	
caroo	t	caro
caroten	b	
carpa	b	
carpintero	b	
carpio	b	
carrantes	b	
carranza	b	
carranzqa	t	carranza
carrascal	b	
carrasco	b	
carrasquilla	b	
carrazco	t	carrasco
carrea	b	
carreño	b	
carreo	b	
carrera	b	
carrerno	b	
carrero	b	
carrido	b	
carrill	b	
carrillo	b	
carrilo	b	
carrino	b	
carrion	b	
carrisosa	b	
carrisoza	b	
carrizal	b	
carrizosa	b	
carrizoza	b	
carrno	b	
carroza	b	
carsama	b	
cartagena	b	
cartes	b	
carubin	b	
carulla	b	
carvaja	t	carvajal
carvajal	b	
carvajalino	b	
carvajañl	t	carvajal
carvajas	t	carvajal
carvakal	t	carvajal
carval	b	
carvalal	t	carvajal
carvalho	b	
carvalja	t	carvajal
carvanza	b	
carvasjal	t	carvajal
carvjal	t	carvajal
carzon	b	
casa	b	
casabuena	b	
casabuenas	b	
casachoa	b	
casadiego	b	
casadiegos	b	
casaghue	b	
casalla	b	
casallas	b	
casalllas	t	casallas
casamarca	b	
casanava	t	casanova
casandro	b	
casanova	b	
casaran	b	
casares	b	
casas	b	
casatellanos	t	castellanos
casatillo	b	
cascante	b	
cascavita	b	
cascielo	b	
casela	b	
caseres	t	caceres
casibanay	b	
casilima	b	
casilimas	b	
casilinas	b	
casillas	b	
casire	b	
casivanay	b	
caslteblanco	t	casteblanco
casrlos	t	carlos
casro	t	castro
casrtillo	t	castillo
casrto	t	castro
casso	b	
castablanco	b	
castallanos	t	castellanos
castalleñeda	b	
castane	b	
castañeda	b	
castaño	b	
castblanco	t	castiblanco
casteblanc	b	
casteblancao	t	casteblanco
casteblanco	b	
casteblancoo	t	castiblanco
castel	b	
castelanco	t	castiblanco
castelbalnco	t	castelblanco
castelblanco	b	
castelblnaco	t	castelblanco
castell	b	
castellamo	b	
castellamos	t	castellanos
castellañeda	b	
castellano	b	
castellaño	t	castellano
castellanos	b	
castellaños	b	
castellar	b	
castellejo	b	
castellenos	t	castellanos
castelllanos	t	castellanos
castello	b	
castellon	b	
casteo	t	castro
castibalco	t	castiblanco
castiblanco	b	
castiblando	t	castiblanco
castiblnaco	t	castiblanco
castiilo	t	castillo
castilblanco	b	
castill	b	
castilla	b	
castillanos	b	
castillejo	b	
castilllo	t	castillo
castillo	b	
castillon	b	
castillos	b	
castilolo	t	castillo
castllanos	t	castellanos
castllo	t	castillo
casto	b	
castrfo	t	castro
castrillo	b	
castrillon	b	
castro	b	
castrol	b	
castula	b	
casulu	b	
catalan	b	
catame	b	
catamo	b	
catano	b	
cataño	b	
catelblanco	t	casteblanco
catellanos	t	castellanos
catibe	b	
catiblanco	t	castiblanco
catica	b	
catilla	t	castilla
catillo	t	castillo
catimav	t	catimay
catimay	b	
cativa	b	
cative	b	
catolico	b	
catomo	b	
catrillon	t	castrillon
catro	b	
catuna	b	
caucil	b	
caulo	b	
causa	b	
causil	b	
cauteles	b	
cavajal	t	carvajal
caval	b	
cavallazzi	b	
cavana	b	
cavanzo	b	
cavarriaga	b	
cavelier	b	
caviadez	b	
caviativa	b	
caviche	b	
cavides	b	
caviedes	b	
cavieles	b	
cavieres	b	
cavirrian	b	
cay	b	
caya	b	
cayachoa	b	
cayagua	b	
cayaguas	b	
caycedo	b	
cayochoa	b	
cayon	b	
cazas	b	
caztro	t	castro
cbra	t	cabra
cbrera	t	cabrera
cchigay	t	cuchigay
ccibo	t	cibo
cdpeda	t	cepeda
cear	b	
ceballos	b	
cebayo	b	
ceceres	b	
cecetares	b	
cecly	t	cely
cedano	b	
cedena	b	
cedeña	b	
cedeno	b	
cedeño	b	
cediel	b	
cedino	b	
ceepeda	t	cepeda
cegua	b	
ceguera	b	
ceidiza	b	
ceija	b	
ceijo	b	
ceilon	b	
cela	b	
celedon	b	
celemin	b	
celi	b	
celia	b	
celis	b	
celix	b	
celiz	b	
celly	b	
cely	b	
celyn	b	
celys	b	
celyu	t	cely
cema	b	
cemida	b	
cenda	b	
cendala	b	
cendales	b	
cendalez	b	
cenejoa	b	
cenejos	b	
ceñis	b	
centena	b	
centeno	b	
cepeda	b	
cepedas	b	
cepedda	t	cepeda
cepedes	t	cespedes
cequeda	b	
cequera	b	
cera	b	
cercadao	t	cercado
cercado	b	
cerda	b	
cerdenas	t	cardenas
ceren	b	
cereno	b	
cerero	b	
cerinza	b	
cerinzana	b	
cerlos	t	carlos
cermen	t	carmen
cerna	b	
cerniza	b	
cero	b	
ceron	b	
cerquera	b	
cerrada	b	
cerrano	b	
cerrato	b	
cerrinza	b	
cerro	b	
certuche	b	
cervantes	b	
cervavtes	t	cervantes
cerveda	b	
cervera	b	
cesa	t	cesar
cesar	b	
cesariz	b	
cespede	t	cespedes
cespedes	b	
cespped	t	cespedes
cesra	t	cesar
cetares	b	
cetin	b	
cetina	b	
cetino	b	
cetuna	b	
cevallos	b	
cevedeo	b	
cevera	b	
cgutierrez	t	gutierrez
ch	b	
chabarrio	b	
chacho	b	
chachope	b	
chacib	b	
chacin	b	
chacn	t	chacin
chaco	b	
chacon	b	
chagua	b	
chaguala	b	
chaguendo	b	
chai	b	
chaka	b	
chala	b	
chalo	b	
chamarravi	b	
chamat	b	
chamberlain	b	
chamizo	b	
chamorro	b	
champeta	b	
champutis	b	
chamucero	b	
chaña	b	
chanacan	b	
chanaga	b	
chantano	b	
chaoarro	t	chaparro
chaoparro	t	chaparro
chapa	b	
chaparo	t	chaparro
chaparoo	t	chaparro
chaparra	b	
chaparrera	b	
chaparro	b	
chaparroa	t	chaparro
chaparrro	t	chaparro
chapeta	b	
chapeton	b	
chaporro	t	chaparro
chapote	b	
chaprro	t	chaparro
chaque	b	
chaquea	b	
chaquez	b	
chaqvita	t	chavita
charat	b	
charcas	b	
charri	b	
charria	b	
charro	b	
charry	b	
charspentier	b	
chasoy	b	
chativa	b	
chauta	b	
chaux	b	
chavaro	t	chavarro
chavarra	b	
chavarria	b	
chavarriaga	b	
chavarrio	b	
chavarro	b	
chaverra	b	
chaves	b	
chavez	b	
chavita	b	
chavorro	b	
chavrez	t	chavez
chchia	t	chia
chemas	b	
chenique	b	
cherleinger	b	
cherry	b	
chevalier	b	
cheverria	b	
chia	b	
chibata	b	
chible	b	
chibuque	b	
chica	b	
chicacausa	b	
chichaco	b	
chichilla	t	chinchilla
chicino	b	
chico	b	
chicuasuque	b	
chidiac	b	
chiguachi	b	
chiguazuque	b	
chil	b	
chila	b	
chilan	b	
chilatra	b	
child	b	
chilito	b	
chillan	b	
chillon	b	
chimbaco	b	
chimbi	b	
chimboroza	b	
chin	b	
chinbi	b	
chinchia	b	
chinchila	b	
chinchilla	b	
chinchilola	b	
chinchina	b	
chingate	b	
chingua	b	
chinime	b	
chinome	b	
chinquilla	t	chinchilla
chiome	b	
chipata	b	
chipatecua	b	
chipiage	b	
chipiaje	b	
chiquillo	b	
chiquisa	b	
chiquixa	b	
chiquiza	b	
chiqullo	t	chiquillo
chiribi	b	
chirivi	b	
chirva	b	
chirveches	b	
chisaba	b	
chisabo	b	
chisavo	b	
chiscal	b	
chiscas	b	
chisica	b	
chisimo	b	
chisind	b	
chisino	b	
chisito	b	
chisson	b	
chistancho	t	cristancho
chitana	b	
chitibo	b	
chitiva	b	
chitivo	b	
chivaquen	b	
chivata	b	
chiviri	b	
chiyon	b	
chizabo	b	
chizavo	b	
chizino	b	
choachi	b	
chochonta	t	choconta
choconta	b	
chogo	b	
cholo	b	
chon	b	
chona	b	
chontal	b	
choon	b	
choque	b	
chorque	b	
chow	b	
chparro	t	chaparro
chung	b	
churque	b	
chuscal	b	
chuth	b	
chuz	b	
ciacuamia	b	
ciandua	b	
ciatame	b	
ciberi	b	
cibides	b	
cibillos	b	
cibo	b	
cicen	b	
cicerery	b	
ciceri	b	
ciceros	b	
cichaca	b	
cicoamia	b	
cicua	b	
cicuamia	b	
cicuania	b	
cicuariza	b	
ciendua	b	
cienfuegos	b	
cierra	t	sierra
cifentes	t	cifuentes
cifientes	t	cifuentes
cifuentas	t	cifuentes
cifuente	t	cifuentes
cifuentes	b	
cifuentesa	t	cifuentes
cifunetes	t	cifuentes
cigua	b	
ciguamia	b	
cihia	t	chia
cimas	b	
cimbaqueba	b	
cinaricicua	t	ciranicicua
cinjar	b	
cintura	b	
cipa	b	
cipacon	b	
cipagaaauta	t	cipagauta
cipagaut	t	cipagauta
cipagauta	b	
cipagauto	b	
cipaguata	t	cipagauta
cipaguta	t	cipagauta
cipamocha	b	
cipamoha	t	cipamocha
cipamopcha	t	cipamocha
cipamuchas	t	cipamocha
cipgauta	t	cipagauta
ciprian	b	
ciramiciena	b	
ciranicicua	b	
ciranigua	b	
cirata	b	
circa	b	
circua	b	
cirsitina	t	cristina
ciseri	b	
cisnero	b	
cisneros	b	
cistancho	b	
citiño	t	cutino
ciuta	b	
civo	b	
civran	b	
ciza	b	
cizcaya	b	
cizo	b	
cjavez	t	chavez
claderon	t	calderon
claquinco	b	
claro	b	
claros	b	
claude	b	
clausen	b	
claveriro	b	
clavijo	b	
clderon	t	calderon
cleis	b	
clement	b	
clements	b	
cleves	b	
cley	b	
clis	t	celis
clopatosky	b	
cly	t	cely
cmacho	t	camacho
cmargo	t	camargo
coba	b	
cobarcos	b	
cobaria	b	
cobayan	b	
cobiativa	b	
cobides	t	cubides
cobo	b	
cobos	b	
cobra	b	
coca	b	
cocha	b	
cochero	b	
cochica	b	
cochigoy	b	
cocinero	b	
cocoma	b	
coconuba	b	
coconubo	b	
coconuco	b	
coconuva	b	
cocunero	b	
cocunuba	b	
cocunubo	b	
cocunuvo	b	
cocuy	b	
codero	b	
codo	b	
codoba	t	cordoba
codoy	b	
cofles	b	
cogaria	b	
cogollo	b	
cogollos	b	
cogoyo	b	
cogua	b	
cohecha	b	
cojo	b	
colachida	b	
colbert	b	
colemnares	t	colmenares
coley	b	
colina	b	
collantes	b	
collazos	b	
colmebares	t	colmenares
colmemares	t	colmenares
colmenare	t	colmenares
colmenares	b	
colmenarez	b	
colmeneares	t	colmenares
colmenres	t	colmenares
colmeres	b	
colmnenares	t	colmenares
colomba	b	
colon	b	
colorado	b	
colorados	b	
columna	b	
columua	b	
comallan	b	
comargo	t	camargo
comas	b	
comayan	b	
comayande	b	
comayon	b	
comba	b	
combana	b	
combariza	b	
combita	b	
combriza	t	combariza
comenares	t	colmenares
comesana	b	
comesaquira	b	
comeyano	b	
comez	t	gomez
comezaquira	b	
comino	b	
compo	t	campo
comvers	b	
conave	b	
conay	b	
conbariza	t	combariza
concha	b	
concho	b	
concicion	b	
concision	b	
concol	b	
conde	b	
condia	b	
condisa	b	
condiza	b	
condo	b	
condono	b	
conejo	b	
coneo	b	
conga	b	
congo	b	
congrains	b	
congua	b	
conguta	b	
cono	b	
conon	b	
consicion	b	
consilcion	t	consicion
constante	b	
consuegra	b	
contador	b	
conte	b	
contento	b	
conteras	t	contreras
contichara	b	
continchara	b	
continchra	t	continchara
contraras	t	contreras
contrera	b	
contrerar	t	contreras
contreras	b	
contrerisa	t	contreras
contreros	b	
contresas	t	contreras
contretas	t	contreras
contrras	t	contreras
copa	b	
copasachoa	b	
copcio	b	
copete	b	
copez	b	
coqueco	b	
coquira	b	
cor	b	
coradine	b	
coradino	b	
coral	b	
corales	b	
coranado	t	coronado
corba	b	
corcho	b	
corchuelo	b	
corcobado	b	
corcovado	b	
cordaba	t	cordoba
cordeles	b	
cordero	b	
corderop	t	cordero
cordoba	b	
cordoban	t	cordoba
cordon	b	
cordova	t	cordoba
coredero	t	cordero
coredor	t	corredor
cores	b	
corlos	t	carlos
corlosana	b	
cornejo	b	
cornelio	b	
cornieles	b	
coro	b	
coroanado	t	coronado
corobado	t	coronado
corona	b	
coronado	b	
coronal	t	coronel
coronel	b	
cororado	b	
corozo	b	
corpas	b	
corpus	b	
corradine	b	
corral	b	
corrales	b	
corrdedor	t	corredor
corrder	t	corredor
corrdor	t	corredor
correa	b	
correal	b	
correales	b	
correalez	t	correales
correcha	b	
correda	t	correa
correddor	t	corredor
corredin	b	
corredo	t	corredor
corredoe	t	corredor
corredop	t	corredor
corredor	b	
corredos	b	
corregidor	b	
correin	b	
correjidor	b	
correo	t	correa
correra	b	
correro	b	
corresa	b	
correz	b	
corrisidor	b	
corrrea	t	correa
corse	b	
corsi	b	
corso	b	
corssi	b	
corsso	t	corso
corssy	b	
cortaza	t	cortazar
cortazar	b	
corte	b	
cortela	b	
cortes	b	
cortez	b	
cortina	b	
cortres	b	
corts	t	cortes
corzo	b	
corzp	t	corzo
cosguen	b	
cosinero	b	
cosio	b	
cossio	b	
costa	b	
costilla	b	
costo	b	
cota	b	
cotachira	b	
cotame	b	
cotamo	b	
cotano	b	
cote	b	
coteiro	b	
coterio	b	
cotes	b	
cotichara	b	
cotinchara	b	
cotinchera	b	
cotinchira	b	
cotomo	b	
cotrina	b	
cotrinchara	b	
cotrino	b	
cotte	b	
coucha	b	
cova	b	
covaleda	b	
covaria	b	
covo	t	cobo
covos	b	
cowdia	b	
coy	b	
coyogo	b	
coyu	b	
coyva	b	
cozoñez	b	
cqastro	t	castro
cradozo	t	cardozo
crane	b	
crazon	t	carzon
crdenas	t	cardenas
crdens	t	cardenas
crdozo	t	cardozo
crespo	b	
creuz	t	cruz
criado	b	
criales	b	
crintancho	t	cristancho
criollo	b	
cririvi	t	chirivi
crisales	b	
crisanto	b	
crismaldo	b	
crispin	b	
crispo	b	
cristacho	t	cristancho
cristamcho	t	cristancho
cristanch	t	cristancho
cristancho	b	
cristanco	t	cristancho
cristanelto	b	
cristanncho	t	cristancho
cristano	b	
cristanto	b	
cristianao	t	cristiano
cristiano	b	
cristina	b	
cristino	t	cristiano
cristna	t	cristina
cristnacho	t	cristancho
cristrina	t	cristina
critancho	t	cristancho
critina	t	cristina
crmen	t	carmen
croes	b	
croso	b	
cross	b	
crosso	b	
crrea	t	correa
crrerdor	t	corredor
crsitancho	t	cristancho
crsitiano	t	cristiano
crstina	t	cristina
crtisanto	t	crisanto
crua	b	
cruces	b	
crus	t	cruz
cruz	b	
cruza	b	
cruzate	b	
cruzo	b	
csatiblanco	t	castiblanco
cstellanos	t	castellanos
cstillo	t	castillo
ctaño	t	catano
ctruz	t	cruz
cuabides	t	cubides
cuabillos	t	cubillos
cuadra	b	
cuadrado	b	
cuadrados	b	
cuadras	b	
cuadro	b	
cuadros	b	
cualla	b	
cuan	b	
cuanaro	b	
cuaran	b	
cuarez	b	
cuartas	b	
cuasta	b	
cubague	b	
cubanero	b	
cubaque	b	
cuberos	b	
cubides	b	
cubidez	b	
cubillo	b	
cubillos	b	
cubiño	b	
cubiodes	t	cubides
cubises	t	cubides
cubsa	b	
cubuides	t	cubides
cuburuco	b	
cuburucu	t	cuburuco
cubutuco	t	cuburuco
cuca	b	
cucachon	b	
cucaita	b	
cucaite	b	
cucalon	b	
cucanchon	b	
cucarian	b	
cucariano	b	
cucha	b	
cuchala	b	
cuchanga	b	
cuchango	b	
cuchano	b	
cuchay	b	
cuchia	b	
cuchibague	b	
cuchibaque	b	
cuchiga	b	
cuchigay	b	
cuchigaz	b	
cuchigua	b	
cuchilague	b	
cuchimaque	b	
cuchimba	b	
cuchinaque	b	
cuchivage	b	
cuchivague	b	
cuchivaguen	b	
cuchivaque	b	
cuchivaquen	b	
cucida	b	
cuco	b	
cucuaita	b	
cucubana	b	
cucububa	t	cucunuba
cucunuba	b	
cucunubas	b	
cucunubo	b	
cucunuco	b	
cucunuva	b	
cucutes	b	
cudumi	b	
cuebas	t	cuevas
cueevas	t	cuevas
cuella	b	
cuellar	b	
cuellas	b	
cuelllar	t	cuellar
cuello	b	
cuenca	b	
cuenu	b	
cuenza	b	
cuerbo	t	cuervo
cuero	b	
cuervo	b	
cuervos	b	
cuesta	b	
cuestas	b	
cuesto	b	
cuesvas	t	cuevas
cueter	b	
cueva	b	
cuevas	b	
cuevo	b	
cufini	b	
cufino	b	
cufiño	b	
cufuentes	t	cifuentes
cuhena	b	
cui	b	
cuida	b	
cuin	b	
cuineme	b	
cuintiva	b	
cuis	b	
cuisa	b	
cuitiva	b	
cuiza	b	
cujaban	b	
cujabante	b	
cujar	b	
cujavante	b	
cujayan	b	
cujino	b	
cullares	b	
culma	t	culman
culman	b	
cultio	b	
cumaco	b	
cumbal	b	
cumbe	b	
cumbre	b	
cummings	b	
cuna	b	
cuncanchum	t	cucanchon
cuncia	b	
cuniche	b	
cuntinchara	b	
cuoli	b	
cupa	b	
cupaje	b	
cupajita	b	
cupasachoa	b	
cupaschoa	t	cupasachoa
cuper	b	
cupitra	b	
cupitre	b	
cur	b	
curan	b	
curcha	b	
curcho	b	
cure	b	
curmen	b	
curmer	b	
curramba	b	
currea	b	
curtido	b	
curtidor	b	
curtidur	t	curtidor
curva	b	
curvero	b	
curvo	b	
curz	t	cruz
cusaria	b	
cusario	b	
cusba	b	
cusbaque	b	
cusgua	b	
cusguen	b	
cuspoca	b	
cusquen	b	
custa	b	
custillo	b	
cusua	b	
cusva	b	
cuta	b	
cutha	b	
cutidor	t	curtidor
cutino	b	
cutiva	b	
cutivan	t	cutiva
cutive	t	cutiva
cutta	b	
cuttian	b	
cuvides	b	
cuvillos	b	
cuy	b	
cuyamo	b	
cuyamon	b	
cuyano	b	
cuyare	b	
cuyares	b	
cuyda	b	
cuz	t	cruz
cuzaria	t	cusaria
cuzba	b	
d'otero	b	
daga	b	
dagand	b	
dager	b	
dago	b	
dagua	b	
dahuy	b	
daito	b	
daiz	t	diaz
daled	b	
dalel	b	
daleman	b	
dalgado	t	salgado
dallas	b	
dallel	b	
dalllos	t	dallos
dallos	b	
damelines	b	
damerine	b	
damiam	t	damian
damian	b	
danaranjo	b	
dancel	b	
danetra	b	
dangel	t	angel
daniels	b	
danubio	b	
danza	b	
dardenas	t	cardenas
darlix	b	
dativa	b	
davalos	b	
david	b	
davila	b	
davisd	t	david
daza	b	
dazail	b	
dazas	b	
dazo	b	
dazza	t	daza
dde	t	de
ddiaz	t	diaz
de	b	
deantonio	b	
deaquiz	b	
deavique	b	
deaz	t	diaz
debia	b	
decely	b	
dederle	b	
dedios	b	
dedx	b	
defreitas	b	
deg	t	de
degundo	t	segundo
dehaquin	b	
dehaquiz	b	
deibyd	b	
deiz	t	diaz
dej	t	de
dejoy	b	
delcadillo	t	delgadillo
deldadillo	t	delgadillo
delgadao	t	delgado
delgadilla	t	delgadillo
delgadillo	b	
delgado	b	
delgtado	t	delgado
delher	b	
demeta	b	
denegri	b	
deossa	b	
deoyes	b	
depablo	b	
depablos	b	
depaulo	t	depablo
der	t	de
derle	b	
descue	b	
devia	b	
dia	b	
diab	t	dia
diaff	b	
diagama	b	
dianetra	b	
diaquive	b	
diaquiz	b	
diar	b	
diarte	b	
dias	b	
diaz	b	
diaza	b	
diazz	t	diaz
dicata	b	
dicelis	b	
didachis	b	
dieterich	b	
dietes	b	
diez	b	
diller	b	
dilva	b	
dimate	b	
dinagas	b	
dinserna	b	
dion	b	
dionicio	b	
diordober	b	
diran	t	duran
dirgua	b	
disanto	b	
dishington	b	
ditilipo	b	
ditta	b	
diuaz	t	diaz
divantoque	b	
diz	b	
diza	t	diaz
dlaikan	b	
doblado	b	
doctor	b	
domico	b	
dominga	b	
dominguez	b	
dominioni	b	
donado	b	
donato	b	
donatos	t	donato
doncel	b	
doncell	t	doncel
doncely	b	
doneira	b	
donoso	b	
donosso	t	donoso
donso	t	donoso
dorado	b	
dorronsoro	b	
dosa	b	
dosantos	b	
dotnato	t	donato
dotor	b	
dottor	b	
dousdebes	b	
doval	b	
dovigamo	b	
doyaca	t	boyaca
doza	b	
dran	b	
drozo	t	rozo
dse	t	de
dsiaz	t	diaz
dualdron	b	
duanca	b	
duaño	b	
duarte	b	
duate	t	duarte
ducan	b	
ducat	b	
duccon	b	
ducely	b	
ducerna	b	
ducnai	b	
ducon	b	
ducuara	b	
ducuaya	b	
ducura	b	
duella	b	
duena	t	duenas
duenas	b	
dueñas	b	
dueñaz	t	duenas
duendes	b	
dueñes	b	
dueñez	b	
duenñas	t	duenas
duenñs	t	duenas
dueñs	t	duenas
duerte	b	
dugan	t	dugand
dugand	b	
duin	b	
duitam	t	duitama
duitama	b	
dukon	b	
dulce	b	
dulcey	b	
dumit	b	
duñas	t	duenas
dunza	b	
dupuis	b	
duque	b	
duquino	b	
dura	t	duran
durain	t	duran
dural	t	duran
duram	t	duran
duran	b	
durando	b	
durango	b	
duret	b	
dursan	b	
durte	t	duarte
dusan	b	
dussan	b	
duzan	t	dusan
duzman	t	guzman
dyaban	b	
dza	t	daza
ecarraga	b	
eceheverria	t	echeverria
ecehverria	t	echeverria
ecero	t	acero
ecerra	b	
ecevedo	t	acevedo
echandia	b	
echavarria	b	
echeberria	t	echeverria
echecerria	t	echeverria
echenique	b	
echeñique	b	
echevarria	t	echavarria
echeveri	t	echeverri
echeverri	b	
echeverria	b	
echeverrria	t	echeverria
echeverry	b	
echevery	t	echeverry
ecley	t	cley
edegua	b	
eden	b	
edstepa	t	estepa
eduen	t	eden
egue	b	
egues	t	egue
ehuertas	t	huertas
eira	t	neira
elandia	t	velandia
elayca	b	
elberto	t	alberto
elcinair	b	
elisalde	b	
elizalde	b	
elizande	b	
elon	b	
elorza	b	
eman	b	
emayuza	t	mayuza
embus	b	
emeraude	b	
emilton	t	milton
emndoza	t	mendoza
emus	b	
enao	t	henao
encinales	b	
encino	b	
encinosa	b	
encinoza	b	
encisa	t	enciso
enciso	b	
encizo	b	
endara	b	
ende	b	
endes	b	
endieta	t	mendieta
enemeguen	b	
enerdi	b	
enerida	b	
enerique	t	enrique
engativa	b	
enirique	t	enrique
enpinosa	t	espinosa
enriique	t	enrique
enriqe	t	enrique
enriqiue	t	enrique
enriqu	t	enrique
enrique	b	
enriques	b	
enriquez	b	
enriquue	t	enrique
enrrique	t	enrique
ensinales	b	
ensinosa	b	
entelis	b	
enteliz	b	
entralgo	b	
eodriguez	t	rodriguez
eon	t	leon
epinel	t	espinel
epinosa	t	espinosa
epitia	t	espitia
epuleyo	t	apuleyo
eque	b	
eral	b	
eraso	b	
erasso	b	
erazo	b	
erdugo	t	verdugo
eregua	b	
erenas	t	arenas
erevalo	t	arevalo
erez	b	
erim	b	
erincon	t	rincon
erjola	b	
erlugo	b	
ernandez	t	hernandez
esamilla	t	escamilla
esaquita	b	
escala	b	
escalanta	t	escalante
escalante	b	
escaleras	b	
escallon	b	
escalon	b	
escalona	b	
escalone	t	escalona
escamilla	b	
escandon	b	
escarpeta	b	
escarra	b	
escarraga	b	
escarrasa	b	
escarraya	t	escarraga
escarria	b	
escatico	b	
escobal	t	escobar
escobar	b	
escobedo	b	
escolante	t	escalante
escorcia	b	
escorial	b	
escovar	b	
escovedo	b	
escribel	b	
escudero	b	
escuraina	b	
esencion	t	ascencion
esfebes	b	
esguerra	b	
esitia	t	espitia
eslaba	t	eslava
eslava	b	
eslavia	t	eslava
eslizalde	t	elizalde
esmeral	b	
esmith	b	
espalsa	b	
espalse	t	espalsa
españa	b	
español	b	
esparza	b	
espejo	b	
espeleta	b	
espiita	t	espitia
espinal	b	
espindola	b	
espindolas	t	espindola
espinel	b	
espineles	b	
espines	b	
espinillo	b	
espiniosa	t	espinosa
espinisa	t	espinosa
espino	b	
espinos	b	
espinosa	b	
espinose	t	espinosa
espinoso	t	espinosa
espinoza	b	
espiti	t	espitia
espitia	b	
espitita	t	espitia
espitua	t	espitia
esponosa	t	espinosa
esporta	b	
espozo	b	
esptia	t	espitia
esptupiñan	t	estupinan
esqguerra	t	esguerra
esquerra	t	esguerra
esquinas	b	
esquive	t	esquivel
esquivel	b	
esquvel	t	esquivel
esrupiñan	t	estupinan
estacio	b	
estarita	b	
estaubrofilo	t	estaurofilo
estaurofila	t	estaurofilo
estaurofilo	b	
estebal	t	esteban
estebam	t	esteban
esteban	b	
estebez	t	estevez
estepa	b	
estevan	t	esteban
esteve	t	estevez
esteves	t	estevez
estevez	b	
estipiñan	t	estupinan
estpiñan	t	estupinan
estrada	b	
estremon	b	
estrumont	b	
estuiñan	t	estupinan
estuñiñan	t	estupinan
estupinan	b	
estupiñana	t	estupinan
estupiñanm	t	estupinan
estupinilla	b	
estupiñna	t	estupinan
estupñan	t	estupinan
estupuñan	t	estupinan
etupiñan	t	estupinan
euge	b	
eulegelo	b	
eulejelo	t	eulegelo
eusse	b	
ewspitia	t	espitia
ezediel	t	cediel
ezpitia	t	espitia
faaustino	t	faustino
fabiam	t	fabian
fabian	b	
fabra	b	
fabrega	b	
fabustino	t	faustino
fache	b	
fafan	t	farfan
fagua	b	
faitoque	b	
faizal	b	
fajardo	b	
fajardop	t	fajardo
fajaro	t	fajardo
falck	b	
falfonso	t	alfonso
falk	t	falck
falla	b	
fanco	t	franco
fandiño	b	
faqua	b	
faracica	b	
farad	b	
farafan	t	farfan
farah	b	
faran	t	farfan
farasica	b	
farcia	t	faracica
faresica	t	farasica
farfa	t	farfan
farfan	b	
farfen	t	farfan
fargua	b	
farian	t	farfan
farias	b	
faridas	t	farias
farigua	b	
faroas	t	farias
farrera	t	barrera
fartfan	t	farfan
fasgua	b	
faua	t	faura
fauga	t	faura
fauistino	t	faustino
faura	b	
faustino	b	
fautoque	b	
favian	b	
fayal	b	
fcalderon	t	calderon
fcavieles	t	cavieles
fechas	t	flechas
federico	b	
feeeucho	t	ferrucho
fegueredo	t	figueredo
fegueroa	t	figueroa
feis	t	felix
feix	t	felix
felexis	t	felix
feligrana	b	
feliux	t	felix
felix	b	
felizola	b	
felizzola	b	
femayor	b	
fenandez	t	fernandez
feng	b	
fenix	b	
fenrnadez	t	fernandez
fenwarth	b	
feo	b	
feqlix	t	felix
ferardo	t	gerardo
fereira	t	ferreira
feres	b	
ferez	b	
feria	t	ferias
ferias	b	
ferla	b	
fernadez	t	fernandez
fernadnez	t	fernandez
fernanadez	t	fernandez
fernanddez	t	fernandez
fernandes	t	fernandez
fernandez	b	
fernanez	t	fernandez
fernasndez	t	fernandez
ferrari	b	
ferraro	b	
ferreira	b	
ferrer	b	
ferrere	b	
ferrerira	t	ferreira
ferro	b	
ferrucho	b	
fetecha	b	
fetecua	b	
fetegua	t	fetecua
fflor	t	flor
fgueredo	t	figueredo
fgueroa	t	figueroa
fiaga	b	
fiagat	b	
ficarative	t	firacative
fich	b	
fierro	b	
figeredo	t	figueredo
figeroa	t	figueroa
fighetti	b	
figuera	t	figueroa
figuerea	t	figueroa
figueredo	b	
figuereo	t	figueroa
figuereso	t	figueredo
figueroa	b	
figueron	t	figueroa
figuerora	t	figueroa
figuerredo	t	figueredo
fihueroa	t	figueroa
fijardo	t	fajardo
fil	t	gil
filete	b	
finacative	t	firacative
fini	t	fino
fino	b	
fioga	b	
fique	b	
fiquitiva	b	
firacatibe	t	firacative
firacativa	t	firacative
firacative	b	
firacavita	b	
firaintive	t	firacative
firatan	b	
firavitoba	b	
firavitova	t	firavitoba
firaya	b	
firegoa	t	figueroa
fitata	b	
fitzerald	b	
flandin	b	
flautero	b	
flauteros	b	
flechas	b	
flechaz	t	flechas
flecher	b	
fletscher	b	
floa	t	flor
floe	t	flor
floiran	b	
flor	b	
floredi	b	
floredy	b	
floreña	b	
flores	b	
floresta	b	
florez	b	
florian	b	
floriano	b	
florido	b	
florin	t	florian
florio	b	
florz	t	florez
flotcher	b	
flrian	t	florian
flro	t	flor
foche	b	
foereo	t	forero
fojas	t	rojas
foler	t	soler
folorez	t	florez
fomeque	b	
fomez	b	
fonca	t	fonseca
fonceca	b	
fondesa	b	
fonegra	b	
fonnegra	b	
fonque	b	
fonsca	t	fonseca
fonsdeca	t	fonseca
fonse	t	fonseca
fonsea	t	fonseca
fonsec	t	fonseca
fonseca	b	
fonsecas	t	fonseca
fonsecva	t	fonseca
fonsenca	t	fonseca
fontacha	b	
fontal	t	fontalvo
fontalvo	b	
fontana	b	
fonteca	t	fonseca
fontecha	b	
fonteche	b	
fonzalez	t	gonzalez
foque	t	fonque
for	t	flor
fora	b	
foraquira	b	
ford	b	
foremo	t	forero
foreo	t	forero
forer	t	forero
forera	t	forero
forero	b	
fores	t	flores
forestiery	b	
forestiri	b	
forgioni	b	
forigua	b	
foringua	t	forigua
foronda	b	
forrero	t	forero
fortaleche	b	
fosca	t	fonseca
foseca	t	fonseca
fosenca	t	fonseca
fracassi	b	
fracica	b	
frade	b	
fragoso	b	
fragoza	b	
fragozo	b	
fragua	b	
fraile	b	
frailes	b	
fralie	t	fraile
framos	b	
francesconi	b	
francescony	b	
francia	b	
francica	b	
francisci	b	
franco	b	
francos	t	franco
franky	b	
frasco	b	
frasica	b	
frayle	b	
freile	b	
freite	b	
freitte	t	freite
frendo	b	
fresmo	b	
fresneda	b	
fresno	b	
frezneda	t	fresneda
frias	b	
friedris	b	
frisneda	t	fresneda
fritz	b	
frius	t	frias
friz	b	
frnaco	t	franco
frnco	t	franco
frontal	b	
frorez	t	florez
fuay	b	
fuenres	t	fuentes
fuenste	t	fuentes
fuentas	t	fuentes
fuente	t	fuentes
fuentees	t	fuentes
fuentes	b	
fuentres	t	fuentes
fuerte	b	
fuertes	b	
fuguene	b	
fugueredo	t	figueredo
fugueroa	t	figueroa
fuisa	b	
fuja	t	fula
fula	b	
fulano	b	
fulla	t	fula
funeme	b	
funes	b	
funetes	t	fuentes
funquen	b	
funume	b	
fuquen	b	
fuquene	b	
fuquenen	t	fuquene
fuques	t	fuquen
fuquiniqui	b	
fuqun	t	fuquen
furmanonski	b	
furmanowski	b	
furque	b	
fuuquene	t	fuquene
fuya	b	
gaarcia	t	garcia
gabanzo	t	gavanzo
gabidia	t	gaviria
gabilan	t	gavilan
gabulo	t	cabulo
gacahntiva	t	gachantiva
gaceno	b	
gacha	b	
gachacoque	t	gachagoque
gachacote	t	gachagoque
gachagoque	b	
gachagote	t	gachagoque
gachancipa	b	
gachantiva	b	
gachapote	t	gachagoque
gacharna	b	
gacharra	b	
gachavita	b	
gachay	b	
gachazoque	t	gachagoque
gachey	b	
gaeces	t	garces
gafaro	b	
gagliardy	b	
gahina	b	
gahona	b	
gaicua	b	
gainco	b	
gaindo	b	
gaitan	b	
gaitn	t	gaitan
gaivis	t	galvis
gaizan	b	
galaeno	t	galeano
galan	b	
galana	b	
galarreta	b	
galarza	b	
galat	b	
galban	t	galvan
galdames	b	
galdamez	b	
galdanes	t	galdames
galeano	b	
galeno	b	
galeon	b	
galero	t	calero
galicia	b	
galido	t	galindo
galind	t	galindo
galindes	b	
galindez	t	galindes
galindo	b	
galino	b	
gallardo	b	
galleano	t	galeano
gallegari	b	
gallego	b	
gallegos	b	
galllo	t	gallo
gallo	b	
gallon	b	
gallos	b	
galofre	b	
galva	b	
galvan	b	
galves	b	
galvez	b	
galvis	b	
galvo	b	
galvys	b	
gama	b	
gamaba	b	
gamarra	b	
gamas	b	
gamba	b	
gambaciaa	t	gambacica
gambacica	b	
gambasica	b	
gambimbo	b	
gambino	b	
gambita	b	
gambo	b	
gamboa	b	
gamero	b	
games	b	
gamesz	t	gamez
gamez	b	
gameza	b	
gamma	b	
gañan	b	
gandia	b	
ganez	b	
gantiva	b	
gantivar	b	
ganzalez	t	gonzalez
ganzalo	t	gonzalo
gaoma	t	gaona
gaona	b	
gapez	b	
garaces	t	garces
garagoa	b	
garantonio	t	carantonio
garavi	t	garavito
garaviño	b	
garavita	t	garavito
garavito	b	
garay	b	
garcel	t	garces
garces	b	
garcez	t	garces
garcia	b	
garcisa	t	garcia
garcoa	t	garcia
garcon	t	garzon
garcz	t	garces
gargas	b	
gargia	b	
garia	t	garcia
garibaldy	b	
garibello	b	
garica	t	garcia
garin	t	guarin
garinica	t	garnica
garizabal	b	
garizabalo	t	garizabal
garnados	t	granados
garndaza	t	granda
garnica	b	
garoya	b	
garra	b	
garrido	b	
garro	b	
garrote	b	
garuajaz	b	
garza	b	
garzo	b	
garzon	b	
garzona	t	garzon
gasca	b	
gascon	b	
gastelblanco	t	castelblanco
gatellanos	t	castellanos
gatiboa	b	
gativa	b	
gaucha	b	
gaucho	t	gaucha
gauna	b	
gauza	b	
gavanzo	b	
gavidia	b	
gavidio	b	
gaviedes	t	caviedes
gavilan	b	
gavilema	b	
gavira	t	gaviria
gaviria	b	
gavirio	t	gaviria
gavirion	t	gaviria
gayon	b	
gazca	b	
gazon	t	garzon
gazuis	b	
gebehart	b	
gegen	b	
gelbes	t	gelvis
gelbis	t	gelvis
gelgado	t	delgado
gelves	b	
gelvez	b	
gelvis	b	
gemines	b	
gempeler	b	
generoso	b	
genes	b	
geos	b	
gerando	t	gerardo
gerardo	b	
gereda	b	
gereman	t	german
gerena	b	
gerenas	b	
gerez	b	
germam	t	german
german	b	
germen	t	german
geromito	b	
geronimo	b	
gerra	t	guerra
gerrardo	t	gerardo
gerrero	b	
gesuy	b	
getiva	b	
geurra	t	guerra
gevara	t	guevara
gevel	b	
gex	b	
ggonzalez	t	gonzalez
gherman	t	german
ghernandez	t	hernandez
ghiraldo	t	giraldo
gifuni	b	
gil	b	
gila	b	
gilc	t	gil
gilde	b	
gilede	t	gilde
gillen	b	
gilleon	b	
ginzalez	t	gonzalez
gio	b	
giocon	b	
giol	b	
gionzalez	t	gonzalez
girad	b	
giral	b	
giraldo	b	
giraldor	t	giraldo
giralfo	t	giraldo
girardot	b	
girata	b	
girdillo	t	gordillo
girley	b	
girom	t	giron
giron	b	
gitierrez	t	gutierrez
giul	b	
giuo	t	guio
gloor	b	
glotia	b	
gmez	t	gomez
gobelay	b	
gocharna	b	
godoy	b	
goems	t	gomez
goemz	t	gomez
goenaga	b	
goes	b	
goimez	t	gomez
gojo	t	cojo
gollo	b	
gome	t	gomez
gomea	t	gomez
gomes	t	gomez
gomez	b	
gomeza	t	gomez
gomezaquira	b	
gomnez	t	gomez
gomrz	t	gomez
gomzalez	t	gonzalez
gonalez	t	gonzalez
gonalo	t	gonzalo
gonazalez	t	gonzalez
gonazlez	t	gonzalez
gondellez	b	
goneche	b	
gongora	b	
gonmez	t	gomez
gonmzalez	t	gonzalez
gonnzalez	t	gonzalez
gonsalez	b	
gonsalo	t	gonzalo
gonxalez	t	gonzalez
gonzaelz	t	gonzalez
gonzaez	t	gonzalez
gonzaklez	t	gonzalez
gonzale	t	gonzalez
gonzalea	t	gonzalez
gonzales	b	
gonzalez	b	
gonzalezs	t	gonzalez
gonzallez	t	gonzalez
gonzalñez	t	gonzalez
gonzalo	b	
gonzalwez	t	gonzalez
gonzaqlez	t	gonzalez
gonzelez	t	gonzalez
gonzelz	t	gonzalez
gonzlaez	t	gonzalez
gonzlalez	t	gonzalez
gonzxalez	t	gonzalez
gonzzalez	t	gonzalez
goodman	b	
goowin	b	
goray	b	
gorda	b	
gordillo	b	
gordilloa	t	gordillo
gordilo	t	gordillo
gordo	b	
gordoillo	t	gordillo
gorlini	b	
gornazlez	t	gonzalez
goroneche	b	
gorosso	t	grosso
gorrais	b	
gorraiz	b	
gorsillo	t	gordillo
gorss	t	gross
gosa	t	osa
gote	t	cote
govilema	b	
goya	b	
goyaneche	t	goyeneche
goyenche	t	goyeneche
goyeneche	b	
goyes	b	
goyoneche	t	goyeneche
gozalez	t	gonzalez
gozalo	t	gonzalo
gpmez	t	gomez
gracia	b	
gracianes	b	
graciano	b	
graciario	t	graciano
gracino	t	graciano
graff	b	
grajales	b	
granada	b	
granadillo	b	
granado	b	
granados	b	
granandos	t	granados
granaos	t	granados
granbados	t	granados
granda	b	
grandas	b	
grande	b	
grandeth	b	
grandini	b	
grandona	b	
grandos	b	
granga	t	granja
granja	b	
granobles	b	
granos	b	
gras	t	grass
grass	b	
grau	b	
grazo	b	
grcia	t	garcia
gregorelli	b	
greiff	b	
grenas	t	arenas
greze	b	
grigalba	t	grijalba
grijaba	t	grijalba
grijalba	b	
grijalbam	t	grijalba
grijalbna	t	grijalba
grijalbo	t	grijalba
grijaldo	t	giraldo
grijalva	t	grijalba
grimaldo	b	
grimaldos	b	
grinaldo	t	grimaldo
grisalba	b	
grisales	b	
grisalez	b	
grisalva	b	
grismaldo	b	
grismaldos	b	
grisnaldo	b	
grizalba	b	
grizalez	b	
grnados	t	granados
grnde	t	grande
grofe	b	
gros	b	
grosclaude	b	
groso	b	
gross	b	
grosso	b	
grossom	t	grosso
grozo	b	
grueso	b	
gruezo	t	grueso
gsrcia	t	garcia
gtierrez	t	gutierrez
guababe	b	
guabave	b	
guaca	b	
guacabare	b	
guacaneme	b	
guacaneque	b	
guacanome	b	
guacarapare	b	
guacararare	t	guacarapare
guacavare	b	
guacha	b	
guache	b	
guacheta	b	
guachiton	b	
guacho	t	guache
guadalajara	b	
guadia	b	
guaduas	b	
guage	b	
guagueta	b	
guaicaramo	b	
guaidi	b	
guaidia	b	
guais	b	
guaita	b	
guaitero	b	
guaiteros	b	
guaitiva	b	
guaitoto	b	
guaiz	b	
guaje	b	
guajes	t	guaje
guakida	b	
gualdaron	t	gualdron
gualdron	b	
gualli	b	
gualorro	b	
gualtereos	t	gualteros
gualtero	t	gualteros
gualteros	b	
gualtron	t	gualdron
guamal	b	
guaman	b	
guamay	b	
guamon	b	
guampe	b	
guanai	t	guanay
guanan	b	
guanare	b	
guanari	b	
guanaro	b	
guanaumba	b	
guanave	t	guanare
guanay	b	
guancha	b	
guanchoque	b	
guaneme	b	
guaney	b	
guanin	b	
guanque	b	
guantiva	b	
guanume	t	guanumen
guanumen	b	
guanupe	b	
guapacha	b	
guaque	b	
guaqueta	b	
guaquida	b	
guarain	t	guarin
guarape	b	
guarataro	b	
guardia	b	
guardiola	b	
guarin	b	
guarita	b	
guarnizo	b	
guarope	t	guarupe
guarumo	b	
guarupe	b	
guasarabe	b	
guasca	b	
guasguam	t	guasguan
guasguan	b	
guasguita	b	
guasiruma	b	
guasquen	b	
guasquita	b	
guatagui	b	
guatame	b	
guataqui	b	
guataquira	b	
guataquita	b	
guatava	b	
guatavita	b	
guateque	b	
guatequi	t	guateque
guateros	b	
guatia	b	
guatibonsa	t	guatibonza
guatibonza	b	
guatiboza	t	guatibonza
guatiquira	b	
guativonza	t	guatibonza
guatoque	t	guateque
guatoquero	b	
guauque	b	
guauta	b	
guavare	t	guaviare
guaviare	b	
guavita	b	
guay	b	
guayabal	b	
guayaban	b	
guayabas	b	
guayabo	b	
guayacan	b	
guayacundo	b	
guayambuco	b	
guayancan	t	guayacan
guayanes	b	
guayanez	b	
guayaque	b	
guayara	b	
guayasan	b	
guayata	b	
guayatan	t	guayazan
guayazan	b	
guaydia	b	
guaye	b	
guays	b	
guaza	b	
guazaco	b	
guazguan	b	
guchanga	b	
guchubay	b	
gucuara	b	
gudino	b	
gudiño	b	
guebara	t	guevara
guecha	b	
guedes	b	
gueerrero	t	guerrero
gueman	b	
guencha	b	
guenis	b	
guentes	b	
guenza	b	
guera	t	guerra
guerero	t	guerrero
guerin	t	guarin
guerra	b	
guerreeo	t	guerrero
guerreo	t	guerrero
guerrera	t	guerrero
guerreri	t	guerrero
guerrero	b	
guerreroo	t	guerrero
guerrido	b	
guerrra	t	guerra
guerrreo	t	guerrero
guerrrero	t	guerrero
guerrro	t	guerrero
guesguan	b	
guetierrez	t	gutierrez
guevara	b	
guevaro	t	guevara
guevarra	t	guevara
guevera	t	guevara
guevra	t	guevara
guey	b	
guezguan	b	
guherriz	t	gutierrez
gui	t	guio
guiataqui	t	guataqui
guica	b	
guican	b	
guicha	b	
guiches	b	
guicon	b	
guidado	b	
guierrez	t	gutierrez
guignard	b	
guijo	b	
guila	b	
guilar	t	aguilar
guillan	t	guillen
guillem	t	guillen
guillemin	t	guillen
guillen	b	
guilleng	t	guillen
guillent	t	guillen
guillin	t	guillen
guillon	b	
guin	t	guio
guina	b	
guinand	b	
guinara	b	
guinche	b	
guineo	b	
guineos	b	
guintiva	b	
guio	b	
guiok	t	guio
guiop	t	guio
guiral	b	
guiraldo	t	giraldo
guiroga	t	quiroga
guiron	t	giron
guisa	b	
guisado	b	
guisao	t	guisado
guispi	b	
guiterrez	t	gutierrez
guitieerez	t	gutierrez
guitierrez	t	gutierrez
guitrago	t	buitrago
guiza	b	
guizado	b	
guizao	t	guisado
guizman	t	guzman
guman	t	guzman
guquen	b	
gura	b	
gurerrero	t	guerrero
gurierrez	t	gutierrez
gurin	t	guarin
gurrero	t	guerrero
gurrrero	t	guerrero
gurrute	b	
gurtierrez	t	gutierrez
gusaguita	b	
gusguan	t	guesguan
gusinan	b	
gusman	b	
gut	b	
guta	b	
gutemberg	b	
gutieeres	t	gutierrez
gutieerez	t	gutierrez
gutieerrez	t	gutierrez
gutiereez	t	gutierrez
gutierez	t	gutierrez
gutierrea	t	gutierrez
gutierreez	t	gutierrez
gutierres	t	gutierrez
gutierrez	b	
gutierrgez	t	gutierrez
gutierriez	t	gutierrez
gutierrres	t	gutierrez
gutierrrez	t	gutierrez
gutierrz	t	gutierrez
gutirrez	t	gutierrez
gutirrrez	t	gutierrez
gutoerrez	t	gutierrez
gutuierrez	t	gutierrez
guutierrez	t	gutierrez
guydia	b	
guyeneche	t	goyeneche
guyerrero	t	guerrero
guzaman	t	guzman
guzman	b	
guzmna	t	guzman
habeych	b	
hacitas	b	
hadarbe	t	adarve
haguez	b	
haiza	b	
haller	b	
hamad	b	
hamed	b	
hames	t	james
hamit	b	
hammon	t	hamon
hamon	b	
hanke	b	
hansel	b	
hanssel	b	
hanssen	b	
hara	t	jara
hartnagel	b	
haspe	b	
hasped	t	haspe
hastamorir	b	
haussen	b	
haya	b	
haybore	b	
hayek	b	
hdez	t	hernandez
heano	t	henao
hederich	b	
heer	b	
heerera	t	herrera
hefan	b	
helao	t	henao
hellmers	b	
helmerich	b	
hembus	t	embus
henabergh	b	
henandez	t	hernandez
henao	b	
hende	b	
hendes	t	hende
hennry	t	henry
henriquez	b	
henrrique	t	enrique
henrriquez	t	henriquez
henrry	t	henry
henry	b	
heracra	b	
heranandez	t	hernandez
herandez	t	hernandez
herandnez	t	hernandez
heraque	b	
herchago	b	
herede	t	herederos
herededros	t	herederos
heredeia	t	heredia
herederos	b	
heredia	b	
heredie	t	heredia
heredio	b	
herera	t	herrera
hererera	t	herrera
heres	b	
herfano	t	huerfano
herlen	b	
herlex	b	
hermosa	b	
hermoso	b	
hernadez	t	hernandez
hernanadez	t	hernandez
hernanandez	t	hernandez
hernande	t	hernandez
hernandea	t	hernandez
hernandes	t	hernandez
hernandez	b	
hernandezn	t	hernandez
hernandezs	t	hernandez
hernandezx	t	hernandez
hernandz	t	hernandez
hernanedz	t	hernandez
herndes	t	hernandez
hernendez	t	hernandez
hernesto	b	
hernmadez	t	hernandez
hernnadez	t	hernandez
hernry	t	henry
herra	b	
herrada	b	
herran	b	
herranz	t	herran
herrara	b	
herrea	t	herrera
herreda	t	herrera
herreño	b	
herrera	b	
herrerno	t	herrero
herrero	b	
herrerra	t	herrera
herrerz	t	herrera
herreta	t	herrera
herron	b	
herrra	t	herra
herrrera	t	herrera
herry	t	henry
hertas	t	huertas
herzberg	b	
hidaldo	t	hidalgo
hidalgo	b	
hidrobo	b	
hierro	b	
hifuera	t	higuera
higera	t	higuera
higua	b	
higuera	b	
higueras	b	
higuerra	t	higuera
higuita	b	
higura	t	higuera
hijuela	b	
hikary	b	
hilarion	b	
hill	t	gil
hillan	t	chillan
hillo	t	hillon
hillon	b	
himestroza	t	hinestroza
hincapie	b	
hinchey	b	
hincpapie	t	hincapie
hinderman	b	
hinestroza	b	
hinojojsa	t	hinojosa
hinojosa	b	
hipinto	b	
hisuga	b	
hitola	b	
hlguin	t	holguin
hnery	t	henry
hobaica	b	
hobaika	b	
hoberto	t	roberto
hocaciones	b	
hodges	b	
hoffman	b	
hofman	t	hoffman
hofstra	b	
hoguin	t	holguin
hohorquez	t	bohorquez
hojica	t	mojica
hokira	b	
holano	t	olano
holgin	t	holguin
holgui	t	holguin
holguin	b	
holiguin	t	holguin
hollos	t	hoyos
holmos	b	
holquin	t	holguin
home	b	
homes	t	gomez
homez	t	gomez
honojosa	t	hinojosa
hormanza	t	hormaza
hormasa	t	hormaza
hormaza	b	
hormosa	t	hermosa
hornasa	t	hornaza
hornaza	b	
hornero	b	
horta	b	
hortega	t	ortega
hortua	b	
hosa	t	osa
hosley	b	
hosman	b	
hostios	t	ostios
hostoa	t	hostos
hostos	b	
hosttos	t	hostos
hoy	b	
hoya	b	
hoyoa	t	hoyos
hoyos	b	
hoyota	b	
hozaca	b	
hrnandez	t	hernandez
hrrera	t	herrera
hrrnandez	t	hernandez
huaca	b	
huare	b	
huari	b	
huberin	b	
hucros	t	ucros
hucza	b	
huelgos	b	
huepa	t	huepo
huepo	b	
huepoz	t	huepo
huerdfano	t	huerfano
huerfano	b	
huerfanoi	t	huerfano
huerfia	b	
huergfano	t	huerfano
huerta	b	
huertas	b	
huertaz	t	huertas
huertgas	t	huertas
huertos	b	
huesa	b	
hueso	b	
huestas	b	
huetas	t	huertas
hueza	b	
huezo	b	
huguera	t	higuera
huiguera	t	higuera
huiza	b	
humanez	b	
humay	b	
humba	b	
humbarila	t	umbarila
humo	b	
humos	b	
humus	t	humos
hunco	b	
hunda	b	
hundels	b	
hunza	b	
huratado	t	hurtado
hurbano	t	urbano
hurcia	t	murcia
hureno	b	
hurtada	t	hurtado
hurtadfo	t	hurtado
hurtado	b	
hurtadon	t	hurtado
hurtas	t	huertas
hurtasdo	t	hurtado
hurtatis	b	
hurtdo	t	hurtado
hurtgado	t	hurtado
hurtua	t	hortua
husid	b	
hutado	t	hurtado
huya	t	juya
huyaban	t	uyaban
huyos	t	hoyos
ibaez	t	ibanez
ibagon	b	
ibagua	b	
ibague	b	
ibanen	t	ibanez
ibañes	b	
ibanez	b	
ibaque	b	
ibargue	t	ibarguen
ibarguen	b	
ibariza	b	
ibarra	b	
ibata	t	tibata
ibbalez	t	ibanez
ibenez	t	ibanez
iberia	b	
ibica	b	
ibilba	b	
icaria	b	
icasaque	b	
idarraga	b	
idaz	t	diaz
idealdo	b	
idrobo	b	
iedro	t	pedro
ifuentes	t	fuentes
igantivo	b	
iglesias	b	
igua	b	
iguaque	b	
iguavita	b	
iguera	t	higuera
ijeda	t	ojeda
il	t	gil
ilarion	b	
iliveros	t	oliveros
ilivos	t	olivos
illon	t	hillon
imbus	b	
incapie	t	hincapie
inem	b	
inestroza	b	
infamte	t	infante
infanta	b	
infante	b	
infantes	t	infante
infate	t	infante
ingemat	b	
inicencio	t	inocencio
iño	t	nino
inocencio	b	
inocensio	t	inocencio
inovo	b	
insinarez	b	
ipaco	t	paco
ipuz	b	
ire	b	
iregui	b	
irenaldo	t	reinaldo
iriachi	b	
iriarte	b	
irica	b	
irreno	b	
irreño	b	
irurita	b	
isaguita	b	
isaias	b	
isairias	b	
isais	t	isaias
isaisas	t	isaias
isandoval	t	sandoval
isaquita	b	
isarias	t	isairias
isariza	b	
isasa	b	
isaza	b	
iscatequi	t	uscategui
isias	t	isaias
isquierdo	t	izquierdo
issa	b	
istamo	b	
itacue	b	
itague	t	itacue
itza	b	
ivanes	t	ibanez
ivanez	t	ibanez
ivera	t	rivera
ivica	b	
iza	b	
izairias	t	isairias
izaquita	b	
izaquito	t	izaquita
izariza	b	
izasa	b	
izaza	b	
izquierdo	b	
izquita	t	izaquita
izquito	t	izaquita
jaaman	b	
jaamon	b	
jacanamejoy	t	jacanamijoy
jacanamijay	t	jacanamijoy
jacanamijoy	b	
jacinio	t	jacinto
jacinto	b	
jacome	b	
jaems	t	james
jagama	b	
jagua	b	
jagueyes	b	
jaimes	b	
jaimez	b	
jake	b	
jamaica	b	
james	b	
jamez	t	james
jamillo	t	jaramillo
jamon	t	jaamon
jancito	t	jacinto
jancon	b	
janes	t	james
jaque	b	
jaquive	b	
jara	b	
jaramillo	b	
jaramilo	t	jaramillo
jarrarte	b	
jarro	b	
jasbon	b	
jase	t	jose
jasinto	t	jacinto
jaspe	b	
jasped	t	jaspe
jaspes	t	jaspe
jaspez	t	jaspe
jativa	b	
jaubrique	b	
jauregui	b	
jauregul	t	jauregui
jaurequi	t	jauregui
jaurigui	t	jauregui
jazpe	b	
jegen	b	
jejen	b	
jereda	t	jerena
jeremeias	t	jeremias
jeremias	b	
jereminas	t	jeremias
jerena	b	
jeres	b	
jerez	b	
jerico	b	
jerman	t	german
jeronimo	b	
jerusalen	b	
jespitia	t	espitia
jetelua	b	
jfonseca	t	fonseca
jhome	t	home
jiemenez	t	jimenez
jiemenz	t	jimenez
jienmenez	t	jimenez
jil	b	
jimanez	t	jimenez
jimeez	t	jimenez
jimemez	t	jimenez
jimemnez	t	jimenez
jimene	t	jimenez
jimeneez	t	jimenez
jimenez	b	
jimennez	t	jimenez
jimez	t	jimenez
jimnenez	t	jimenez
jimont	b	
jinete	b	
jiomenez	t	jimenez
jiose	t	jose
jirata	t	girata
jiron	b	
jjose	t	jose
joachin	b	
joae	t	jose
joaya	b	
jode	t	jose
jodse	t	jose
joimenez	t	jimenez
jojoa	b	
jolguin	t	holguin
joncon	b	
jope	t	jose
jopse	t	jose
jorapa	b	
jorigua	b	
jos	t	jose
josa	t	jose
jose	b	
josee	t	jose
joso	t	jose
josr	t	jose
josre	t	jose
jossa	b	
jotamonte	b	
jote	t	jose
jovel	b	
joven	b	
joya	b	
jse	t	jose
jsse	t	jose
juares	b	
juarros	b	
judex	b	
juertas	t	huertas
jues	t	juez
juez	b	
juica	b	
juisa	b	
juiza	b	
jumenez	t	jimenez
junay	b	
junca	b	
junco	b	
juncon	t	junco
jungas	b	
jurada	t	jurado
jurado	b	
juramillo	t	jaramillo
jurao	t	jurado
jurgen	b	
juse	t	jose
justinico	b	
jutinico	b	
juya	b	
juyo	b	
kaleda	b	
kalonge	b	
kammerer	b	
kasma	b	
kassela	b	
kata	t	kattah
katta	t	kattah
kattah	b	
kattam	b	
kencoz	b	
keyeux	b	
kicasaque	b	
kilnger	b	
kimenez	t	jimenez
kincos	b	
klam	b	
klein	b	
klevens	b	
kline	t	klein
kling	b	
klipton	b	
knorr	b	
koaiza	t	loaiza
koch	b	
kolping	b	
konkol	b	
kowoll	b	
kranky	b	
krohne	b	
krohnk	b	
kronfly	b	
kuan	b	
kuehne	b	
kuemher	b	
kuermen	b	
kuhn	b	
kurdore	b	
kure	b	
kurmen	b	
kusguen	b	
kusquen	t	kusguen
la	b	
laba	b	
labado	b	
laberde	t	laverde
laberto	t	alberto
laborde	b	
labrador	b	
lacau	b	
lacerna	b	
lach	b	
lache	b	
lacira	t	alcira
lacruz	b	
lada	b	
ladazabal	t	landazabal
ladeut	b	
ladfino	t	ladino
ladina	b	
ladines	b	
ladino	b	
lado	b	
lael	t	leal
laferty	b	
lafonso	t	alfonso
lagilavo	t	laguilavo
lago	b	
lagos	b	
laguado	b	
laguilavo	b	
laguna	b	
lagunas	b	
laines	b	
lainez	b	
laiseca	b	
laiton	b	
laja	b	
lalarcon	t	alarcon
lalema	b	
lalinde	b	
lamadrid	b	
lamanza	b	
lambaque	b	
lambrano	b	
lambraño	b	
lame	b	
lammoglia	b	
lamoglia	b	
lamonglia	b	
lamos	b	
lamoz	b	
lamprea	b	
lamprera	t	lamprea
lamprez	t	lamprea
lamus	b	
lancacho	b	
lanceros	b	
lanchero	b	
lancheros	b	
lancherosa	t	lancheros
landaeta	b	
landaete	t	landaeta
landar	b	
landarta	t	landaeta
landazabal	b	
landero	t	landeros
landeros	b	
landeta	t	landaeta
landine	t	landinez
landines	b	
landinez	b	
landino	b	
lano	t	llano
lanos	t	llanos
lanziano	b	
lao	b	
laoiza	t	loaiza
lara	b	
larcon	t	alarcon
lardoso	t	cardozo
largacha	b	
largo	b	
largos	b	
larios	b	
larorra	t	larrota
larota	t	larrota
larotha	t	larrota
larotta	b	
larrahondo	b	
larrota	b	
larrotta	b	
larrotya	t	larrota
larrrota	t	larrota
larrson	t	larsson
larrtota	t	larrota
larsson	b	
larte	t	olarte
lartha	t	martha
lasalle	b	
lasare	b	
lascar	b	
laserna	b	
laso	b	
laspriella	b	
lasprilla	b	
lassio	t	lasso
lasso	b	
lastra	b	
lata	b	
latica	b	
latino	b	
latoore	t	latorre
latorre	b	
latrigia	t	latriglia
latriglea	t	latriglia
latriglia	b	
latrilla	b	
laureador	b	
lavachuco	b	
lavacucde	t	lavacude
lavacucho	t	lavachuco
lavacude	b	
lavacudes	t	lavacude
lavacundo	b	
lavado	b	
lavao	b	
lavarde	t	laverde
lavarez	t	alvarez
laverde	b	
lavverde	t	laverde
laytom	t	layton
layton	b	
lazam	b	
lazema	b	
lazo	b	
lbino	b	
lconpongula	b	
leal	b	
lean	t	leon
leandro	b	
leaño	b	
leberman	b	
leclerco	b	
lecs	b	
ledesma	b	
ledezma	t	ledesma
lee	b	
leed	b	
legisamon	t	leguizamon
legizamo	t	leguizamo
legizamon	t	leguizamon
legro	b	
leguisamon	t	leguizamon
leguizamano	t	leguizamon
leguizamo	b	
leguizamom	t	leguizamon
leguizamon	b	
leguizanom	t	leguizamon
leguizmon	t	leguizamon
leguzamon	t	leguizamon
leimai	b	
leimar	b	
leiton	b	
leiva	b	
lelosa	t	velosa
lema	b	
lemer	b	
lemes	b	
lemis	b	
lemjs	t	lemis
lemmus	t	lemus
lemos	b	
lemues	t	lemus
lemus	b	
lemuz	b	
lenguas	b	
lengupa	b	
lenis	b	
lenus	t	lenis
lenz	b	
leon	b	
leones	b	
leonz	t	leon
lequizamo	t	leguizamo
lequizamon	t	leguizamon
lequizanib	t	leguizamon
lequizazmon	t	leguizamon
lerl	b	
lerma	b	
lersunat	b	
lescano	b	
lesmas	b	
lesmes	b	
lesmez	b	
letrado	b	
letredo	t	letrado
leudo	b	
leuro	b	
levaco	b	
leverde	t	laverde
levolos	b	
ley	b	
leyedion	b	
leyes	b	
leyton	b	
leyva	b	
leyvae	t	leyva
leyvan	t	leyva
lezcano	t	lizcano
lezmet	b	
liano	t	llano
lianres	t	linares
libano	b	
liberado	t	liberato
liberato	b	
libertador	b	
libos	b	
licht	b	
licuano	b	
liebano	t	lievano
lievano	b	
lifan	b	
light	b	
lignapolo	b	
liguizamon	t	leguizamon
lilia	b	
lilzarazo	t	lizarazo
lima	b	
limas	b	
limate	b	
limbana	t	lombana
limenez	t	jimenez
limont	b	
limor	b	
limpas	b	
lina	b	
linares	b	
linarez	b	
lince	b	
lindado	b	
lindagua	b	
lindo	b	
linero	b	
lineros	b	
lira	b	
liral	t	lira
lirazo	t	lizarazo
liroyas	b	
liroyaz	b	
lisarazo	b	
liscano	b	
lismes	t	lesmes
lisso	b	
liuna	t	luna
livano	t	lievano
livarez	t	olivarez
liverato	b	
liveros	b	
lizaraso	t	lizarazo
lizarazao	t	lizarazo
lizarazo	b	
lizardo	b	
lizarozo	t	lizarazo
lizca	b	
lizcano	b	
lizoir	b	
lizrazo	t	lizarazo
llach	b	
llagsha	b	
llamosa	b	
llanes	b	
llañes	b	
llanez	b	
llano	b	
llanos	b	
lleras	b	
llerena	b	
lloreda	b	
llorente	b	
loaisa	t	loaiza
loaita	t	loaiza
loaiza	b	
loasa	t	loaiza
lobanton	t	lobaton
lobaton	b	
lobera	b	
lobo	b	
lobon	b	
loche	b	
loen	t	leon
loepez	t	lopez
loepz	t	lopez
loez	t	lopez
logato	b	
loiaza	t	loaiza
loiton	t	leiton
loiza	t	loaiza
loma	b	
lombada	t	lombana
lombana	b	
lombano	t	lombana
lombo	b	
lombraño	b	
lomoana	t	lombana
londoño	b	
loockan	b	
loopez	t	lopez
loor	b	
lopaez	t	lopez
lopaz	t	lopez
lopea	t	lopez
lopeas	t	lopez
lopera	b	
lopes	t	lopez
lopesz	t	lopez
lopexz	t	lopez
lopez	b	
lopeza	t	lopez
lopezana	b	
loppez	t	lopez
lopra	t	lopera
loprez	t	lopez
loprx	t	lopez
loprz	t	lopez
loptz	t	lopez
lopz	t	lopez
lora	b	
loreto	b	
loriza	b	
lorotta	t	larrota
lorrota	t	larrota
lorza	b	
losada	b	
losano	t	lozano
lose	t	jose
lossa	b	
lote	b	
lotero	b	
lotes	b	
lovera	b	
lozad	t	lozada
lozada	b	
lozago	b	
lozamo	t	lozano
lozana	t	lozano
lozano	b	
lozasa	t	lozada
lpoez	t	lopez
lppes	t	lopez
lrmud	b	
lsgos	b	
lsvado	t	alvado
lubaton	t	lobaton
lucas	b	
lucera	b	
lucero	b	
luces	b	
lucrcia	t	lucrecia
lucrecia	b	
lucumi	b	
ludrecia	t	lucrecia
luegan	t	luengas
luegas	t	luengas
luengas	b	
luesca	b	
luga	t	lugan
lugan	b	
lugo	b	
lugue	b	
luilia	t	lilia
lujan	b	
lumbana	t	lombana
lumbaque	b	
lumpaque	b	
lumus	b	
luna	b	
lunas	t	luna
luñez	t	nunez
luns	t	luna
lupaco	b	
luqque	t	luque
luque	b	
luquerna	b	
luquetta	b	
luva	t	uva
luyar	b	
luzardo	b	
luzben	b	
lvarez	t	alvarez
lynn	b	
lyons	b	
maaria	t	maria
maartin	t	martin
maatinez	t	martinez
maca	b	
macabeo	b	
macana	b	
macanas	b	
macea	b	
macedo	b	
maceno	b	
macera	b	
maceta	t	macera
machad	b	
machado	b	
machadp	t	machado
macheggo	t	manchego
machego	t	manchego
macheta	b	
machete	b	
machuc	b	
machuca	b	
machucha	t	machuca
machura	b	
macia	b	
macias	b	
macios	t	macias
maclares	b	
macoalo	t	macualo
macobe	b	
macualo	b	
maculo	t	macualo
madarriaga	b	
maday	b	
madera	b	
maderas	b	
madero	b	
madina	t	medina
madldonado	t	maldonado
mado	b	
madrid	b	
madrigal	b	
madrinan	b	
maecha	b	
maedina	t	medina
maendez	t	mendez
maertinez	t	martinez
maestre	b	
maetha	t	martha
mafilita	b	
mafilito	b	
mafla	b	
mahecha	b	
maia	t	maria
mailes	b	
majia	t	maria
majica	t	mojica
malaber	t	malaver
malaboque	b	
malagan	t	malagon
malagon	b	
malaguera	b	
malambo	b	
malana	b	
malano	t	molano
malanoque	b	
malarios	b	
malavaque	b	
malavar	b	
malaver	b	
malavoque	b	
malba	b	
maldanado	t	maldonado
maldo	b	
maldonad	t	maldonado
maldonado	b	
maldonadonado	t	maldonado
maldonando	t	maldonado
malgon	t	malagon
mallal	b	
mallarino	b	
mallorga	b	
mallungo	b	
malo	b	
malon	b	
malpica	b	
malpico	b	
maluche	b	
malva	b	
malvaer	t	malaver
malver	t	malaver
mamanche	b	
mambuscay	b	
mamore	b	
mamosalva	t	manosalva
mampira	b	
mamria	t	maria
mananche	b	
manare	b	
mancelo	b	
mancera	b	
mancero	b	
manchaes	b	
manchay	b	
mancheco	t	manchego
manchego	b	
manchevo	t	manchego
manchey	b	
manchola	b	
mancilla	b	
mancipa	b	
mancipe	b	
manclares	b	
manco	b	
mandieta	t	mendieta
mandivelso	t	mendivelso
mandon	b	
mandoza	t	mendoza
manent	b	
maner	b	
manfan	b	
manga	b	
mangles	b	
mango	b	
mangos	b	
manhart	b	
mani	b	
manico	b	
manicpe	b	
manisalvo	t	manosalva
manjares	b	
manjarres	b	
manjarrez	b	
manos	b	
manosalba	b	
manosalova	t	manosalva
manosalva	b	
manosalve	t	manosalva
manossalba	t	manosalva
manotas	b	
mañoz	t	munoz
manquique	b	
mañria	t	maria
manrique	b	
manriqueta	t	manriquez
manriquez	b	
manroy	t	monroy
manrrique	t	manrique
manrrrique	t	manrique
manso	b	
mansocua	b	
manta	b	
mantana	t	montana
mantaña	t	montana
mantilla	b	
manzanares	b	
manzaneras	t	manzanares
manzano	b	
manzera	t	mancera
manzipe	t	mancipe
manzo	b	
manzuera	t	mazuera
mape	b	
maqrtha	t	martha
maquez	t	marquez
mara	t	maria
marai	t	maria
maraia	t	maria
maranta	b	
marantes	b	
maraoia	t	maria
maraure	b	
marbueno	b	
marcelo	b	
marchan	b	
marciales	b	
marcias	b	
marcieles	b	
marcipe	t	mancipe
marcol	b	
marcote	b	
marcucci	b	
mare	b	
marenco	b	
mareno	t	moreno
marentes	b	
marftinez	t	martinez
marfua	b	
margffoy	t	margfoy
margfoy	b	
margofoy	t	margfoy
marha	t	martha
marhta	t	martha
maria	b	
mariaca	b	
mariai	t	maria
marial	t	maria
marieca	b	
marillac	b	
marin	b	
marinense	b	
marinez	b	
marini	b	
marino	b	
mariño	b	
mariños	t	marino
mario	t	maria
mariqo	b	
marique	t	manrique
maritinez	t	martinez
maritnez	t	martinez
mariua	t	maria
marjoy	b	
markffoy	t	margfoy
marmo	b	
marmofoy	b	
marmolejo	b	
marofoy	b	
maroia	t	maria
marosalva	t	manosalva
marqez	t	marquez
marqiuez	t	marquez
marque	t	marquez
marquea	t	marquez
marquez	b	
marrera	b	
marrero	b	
marres	b	
marriaga	b	
marroquin	b	
marrugo	b	
marruyo	b	
martah	t	martha
martaha	t	martha
martelo	b	
martes	b	
martga	t	martha
martgin	t	martin
marth	t	martha
martha	b	
marti	b	
martibnez	t	martinez
martienz	t	martinez
martiknez	t	martinez
martin	b	
martinaz	t	martinez
martine	b	
martinea	t	martinez
martineesa	t	martinez
martinel	b	
martinenez	t	martinez
martines	b	
martinexz	t	martinez
martinez	b	
martiñez	t	martinez
martineza	t	martinez
martinezs	t	martinez
martiniez	t	martinez
martinnez	t	martinez
martintez	t	martinez
martrines	t	martinez
martunez	t	martinez
maruez	t	marquez
maruia	t	maria
marulanda	b	
marure	b	
marzo	b	
marzola	b	
masa	b	
masana	b	
mase	b	
masia	b	
masias	b	
masmela	b	
masmelo	b	
masorca	b	
mata	b	
matafira	t	matajira
matajira	b	
matallana	b	
matallano	b	
matallna	t	matallana
matamores	t	matamoros
matamoro	b	
matamoros	b	
matamorro	t	matamoro
mate	b	
mateis	t	mateos
mateos	b	
materon	b	
mateus	b	
mateuz	b	
matha	t	martha
matheus	b	
matias	b	
matilla	b	
matin	b	
matinez	t	martinez
matis	b	
matiz	b	
matoma	b	
matorga	t	mayorga
matos	b	
matrha	t	martha
matria	t	maria
matrinez	t	martinez
matta	b	
mattas	b	
mattinez	t	martinez
mattos	b	
matues	t	mateus
maturana	b	
matute	b	
mauco	b	
mauyorga	t	mayorga
maxime	b	
maya	b	
mayo	b	
mayor	b	
mayoral	b	
mayordomo	b	
mayorga	b	
mayorquin	b	
mayusa	b	
mayusca	b	
mayuza	b	
mazo	b	
mazorca	b	
mazuera	b	
mazutier	b	
mbernal	t	bernal
mcgovern	b	
mdina	t	medina
measa	t	mesa
mebarak	b	
mecan	b	
mecha	b	
mechan	b	
meche	b	
mechen	b	
mechi	b	
mechin	b	
mecias	b	
mecon	b	
medellin	b	
medez	t	mendez
median	t	medina
mediana	t	medina
medida	t	medina
medidna	t	medina
medieta	t	mendieta
medigaño	b	
mediina	t	medina
medillin	t	medellin
medin	t	medina
medina	b	
medinas	t	medina
mediorreal	b	
medivelso	t	mendivelso
mednoza	t	mendoza
medoza	t	mendoza
medrano	b	
meerchan	t	merchan
meguel	t	miguel
mehecha	t	mahecha
meidna	t	medina
meiza	b	
mejia	b	
mejis	t	mejia
mejoa	t	mejia
mejura	b	
meldivelso	b	
melendes	b	
melendez	b	
melendro	b	
melenge	b	
melgarejo	b	
melguiso	b	
melguizo	b	
meli	b	
meljarejo	t	melgarejo
mellizo	b	
melo	b	
melon	b	
memdez	t	mendez
memdoza	t	mendoza
meme	b	
memndoza	t	mendoza
mena	b	
menbdez	t	mendez
menco	b	
mende	t	mendez
mendes	b	
mendez	b	
mendi	b	
mendiata	t	mendieta
mendible	b	
mendicivelso	t	mendivelso
mendienta	t	mendieta
mendieta	b	
mendietac	t	mendieta
mendigano	b	
mendigaño	b	
mendilvelso	b	
mendilveso	t	mendivelso
mendis	b	
mendivelso	b	
mendivelson	b	
mendivelzo	t	mendivelso
mendiveso	b	
mendosa	t	mendoza
mendoz	t	mendoza
mendoza	b	
mendozza	t	mendoza
mendrano	b	
mendvelso	t	mendivelso
mendza	t	mendoza
menece	t	meneses
meneces	b	
menendez	b	
meneses	b	
menez	b	
mengua	b	
meniaura	b	
menidvelso	t	mendivelso
menina	b	
menjuere	t	menjure
menjura	b	
menjure	b	
menjuren	b	
menjuro	t	menjure
menndivelso	t	mendivelso
menodza	t	mendoza
menoza	t	mendoza
mensa	b	
mensen	b	
menvelson	b	
mera	b	
mercado	b	
mercan	t	merchan
mercgan	t	merchan
mercha	b	
mercham	t	merchan
merchan	b	
mereno	t	moreno
meria	t	maria
merida	b	
merido	b	
meriño	b	
merizalde	b	
merlano	b	
merlo	b	
mermudez	t	bermudez
merndez	t	hernandez
mertinez	t	martinez
meryzalde	t	merizalde
mes	b	
mesa	b	
mesas	t	mesa
meschan	t	merchan
mesia	b	
mesjura	t	menjura
mesquera	t	mosquera
messing	b	
mestizo	b	
mestre	t	maestre
meta	b	
metaute	b	
metheus	t	matheus
metraya	b	
metritanios	b	
meza	b	
mezquida	b	
mibuel	t	miguel
mican	b	
michelsen	b	
micolta	b	
miday	b	
mieles	b	
mier	b	
mifuel	t	miguel
migel	t	miguel
migeul	t	miguel
migfuel	t	miguel
migiuel	t	miguel
miguel	b	
miguelñ	t	miguel
miguez	b	
miguiel	t	miguel
migul	t	miguel
migule	t	miguel
mijia	t	mejia
mijica	b	
mijon	b	
mikan	b	
mila	t	milla
milan	b	
miler	b	
militon	t	milton
milla	b	
millan	b	
millares	b	
millarez	b	
millian	t	millan
milpa	b	
milques	b	
milquez	b	
milton	b	
mina	b	
minas	b	
minevar	t	munevar
mingues	b	
minieri	b	
minislav	b	
miño	b	
mioguel	t	miguel
miolina	t	molina
mira	b	
mirabal	b	
miramda	t	miranda
miranada	t	miranda
miranda	b	
mirando	t	miranda
miravalles	b	
mireles	b	
mirone	b	
mirto	b	
misas	b	
misgel	t	miguel
misse	b	
mistral	b	
mitamayo	t	tamayo
mitola	b	
miyares	b	
mjendoza	t	mendoza
mjimenez	t	jimenez
mkarin	t	marin
mkartinez	t	martinez
mmahecha	t	mahecha
mmaria	t	maria
mmartha	t	martha
mmartinez	t	martinez
mmuñoz	t	munoz
mnarique	t	manrique
mnislav	t	minislav
mntañez	t	montanez
moalno	t	molano
moarales	t	morales
mocabe	b	
mocada	t	moncada
mocano	b	
mocha	b	
mocina	b	
mocobe	b	
modera	b	
moerales	t	morales
mogollin	t	mogollon
mogollon	b	
mogolo	b	
mograbejo	b	
moguez	b	
mogui	b	
mohorys	b	
moirales	t	morales
mojica	b	
mojoca	t	mojica
moki	b	
molamo	t	molano
molana	t	molano
molano	b	
molares	b	
molavoque	b	
molila	t	molina
molin	t	molina
molina	b	
molinares	b	
molinet	b	
moliniva	b	
molinna	t	molina
molino	b	
moller	b	
molna	t	molina
molono	t	molina
molrales	t	morales
moltalvo	t	montalvo
momesque	b	
momtañez	t	montanez
mon	b	
mona	t	mora
monacada	t	moncada
monaña	t	montana
monañez	t	montanez
monar	b	
monastoque	b	
monca	b	
moncada	b	
moncaleano	b	
moncaliano	b	
moncayo	b	
monchevo	b	
moncipe	t	mancipe
moncosua	t	monsocua
mondoza	t	mendoza
mondragon	b	
monera	t	munera
monero	t	moreno
monesque	b	
monevar	t	munevar
mongua	b	
mongue	b	
mongui	b	
monina	b	
moniquira	b	
monjarrez	t	manjarrez
monje	b	
monosalva	t	manosalva
monotana	t	montana
monoto	b	
monotya	t	montoya
moñoz	t	munoz
monquira	b	
monroy	b	
monrpy	t	monroy
monrroy	t	monroy
monsalbe	t	monsalve
monsalva	b	
monsalve	b	
monsalvo	t	monsalve
monsave	t	monsalve
monsocua	b	
monsogua	t	monsocua
monsoque	b	
mont	b	
monta	b	
montagui	b	
montagut	b	
montala	t	montana
montalban	b	
montallana	b	
montalvan	b	
montalvo	b	
montana	b	
montaña	b	
montanes	b	
montanez	b	
montaño	b	
montaoya	t	montoya
montaqez	t	montanez
montavita	b	
monte	b	
montealagre	b	
montealegra	t	montealegre
montealegre	b	
montealegro	t	montealegre
monteblanco	b	
montecarlo	b	
monteiel	t	montiel
montejo	b	
montena	b	
montenefro	t	montenegro
montenegre	t	montenegro
montenegro	b	
montenero	t	montenegro
montenez	t	montanez
montengro	t	montenegro
monteno	t	montero
montero	b	
monterrey	b	
monterrosa	b	
monterroza	b	
montes	b	
montez	t	montes
montezuma	b	
montiel	b	
montien	t	montiel
montilla	b	
montilva	b	
montña	t	montana
montnegro	t	montenegro
montñez	t	montanez
montoa	b	
montoña	t	montoya
montosa	b	
montota	t	montoya
montoya	b	
montoyua	t	montoya
montoyya	t	montoya
montrejo	b	
montufar	b	
monza	b	
monzalve	t	monsalve
monzaque	t	monzoque
monzo	b	
monzocua	t	monsocua
monzon	b	
monzoque	b	
moore	b	
mopales	b	
mopntañes	t	montanez
mopreno	t	moreno
moque	b	
moqui	b	
moquira	b	
mora	b	
morakes	t	morales
moral	b	
moralers	t	morales
morales	b	
moralez	b	
moran	b	
morana	t	morano
morano	b	
morante	b	
morantes	b	
morants	t	morantes
morao	b	
morato	b	
morcote	b	
morcotes	b	
more	b	
morea	b	
moreda	t	morera
moreeno	t	moreno
morejo	t	moreno
morela	b	
moreles	b	
morelo	b	
moremo	t	moreno
moren	b	
morenio	t	moreno
moreno	b	
morenop	t	moreno
morenp	t	moreno
morentes	t	marentes
morera	b	
moreras	b	
morerno	t	moreno
morero	b	
morigo	b	
morillo	b	
morles	t	morales
morneo	t	moreno
morno	t	moreno
moro	b	
morocho	b	
moron	b	
moros	b	
moroy	t	monroy
moroz	b	
morphy	b	
morqales	t	morales
morreno	t	moreno
morrillo	t	morillo
morris	b	
morriss	b	
mosalve	t	monsalve
mosco	b	
moscoso	b	
moscote	b	
moser	b	
moseton	b	
moso	t	mosso
mosos	t	mosso
mosquera	b	
mosquerea	t	mosquera
mosquero	t	mosquera
mosqura	t	mosquera
mossel	b	
mosso	b	
mossos	t	mosso
mosucha	b	
mosuera	t	mazuera
mota	b	
motaña	t	montana
motañez	t	montanez
motano	t	moyano
motas	b	
motato	b	
motavita	b	
motenegro	t	montenegro
motiva	b	
motivar	b	
motoa	b	
motta	b	
mottas	t	motta
moure	b	
mouriel	t	muriel
mova	b	
movid	b	
moya	b	
moyana	t	moyano
moyano	b	
moza	t	mozo
mozo	b	
mozquera	t	mosquera
mozuca	b	
mozzo	t	mozo
mpreno	t	moreno
mraia	t	maria
mramos	t	ramos
mrchan	t	merchan
mreno	t	moreno
mria	t	maria
mrndoza	t	mendoza
mroeno	t	moreno
mrtha	t	martha
mrtinez	t	martinez
mucia	t	murcia
muentes	t	fuentes
mueriel	t	muriel
mueses	b	
muete	b	
mugnier	b	
muguel	t	miguel
muir	b	
mujica	b	
muller	b	
mulñoz	t	munoz
mumesque	t	numesque
munar	b	
munca	b	
muncia	t	munca
munebar	t	munevar
munera	b	
muneton	b	
muñetonez	t	muneton
muneva	t	munevar
munevar	b	
munevara	t	munevar
munevvar	t	munevar
munjura	b	
munjuren	b	
munñoz	t	munoz
munñz	t	munoz
munoa	t	munoz
muñoaz	t	munoz
muñon	t	munoz
muños	b	
munoz	b	
muñoz	b	
munpaque	b	
munrvar	t	munevar
muñuz	t	munoz
muon	b	
muoz	b	
mur	b	
murallas	b	
murci	t	murcia
murcia	b	
murcias	t	murcia
murcio	t	murcia
murcone	b	
muria	t	maria
murica	t	murcia
muriel	b	
muriilo	t	murillo
murilli	t	murillo
murillo	b	
muro	b	
murra	b	
murrillo	b	
murte	b	
murthe	b	
muter	b	
mutis	b	
mutiz	t	mutis
mutter	b	
muuunoz	t	munoz
muzzo	b	
naca	b	
nacibar	b	
nacobe	b	
nader	b	
nafar	b	
nafer	b	
naffah	b	
nagad	b	
nagel	b	
nagle	b	
nagles	b	
naiza	b	
naizaque	b	
najar	b	
najas	t	najar
naluz	b	
name	b	
nanclares	b	
nandar	b	
nañez	b	
nanza	b	
nar	b	
narahona	t	barahona
narajo	t	naranjo
naramjo	t	naranjo
naranajo	t	naranjo
naranio	t	naranjo
naranj	t	naranjo
naranja	t	naranjo
naranjo	b	
naranjos	b	
narces	t	garces
narcisa	t	narciso
narciso	b	
nariño	b	
narino	t	marino
narnajo	t	naranjo
nartinez	t	martinez
narvades	t	narvaez
narvaez	b	
nasayon	b	
nassar	b	
nassiri	b	
natera	b	
nates	b	
naula	b	
nausa	b	
nausan	b	
naussan	b	
nauza	b	
nauzan	b	
nava	b	
navajas	b	
navarra	b	
navarre	t	navarra
navarreta	t	navarrete
navarrete	b	
navarro	b	
navarrro	t	navarro
navarrte	t	navarrete
navas	b	
navasa	t	navas
navia	b	
nazar	b	
nazarit	b	
nazola	t	anzola
ncampo	t	campo
ncepeda	t	cepeda
neachan	t	merchan
neche	b	
nega	b	
negret	b	
negrete	b	
negro	b	
negua	b	
nehira	b	
neira	b	
neisa	b	
neissa	b	
neita	b	
neitar	t	neita
neite	b	
neiva	b	
neiza	b	
neme	b	
nemegen	t	nemeguen
nemeguen	b	
nemequen	b	
nemes	b	
nemocom	t	nemocon
nemocon	b	
nemoga	b	
nemojon	b	
nempeque	b	
nempira	b	
ñemus	t	lemus
nendoza	t	mendoza
nenez	b	
neñez	t	nunez
nengua	b	
neño	t	nino
nenpeque	b	
ñeon	t	leon
nernandez	t	hernandez
nesa	b	
nessman	b	
nesta	b	
neusa	b	
neusan	b	
neussa	b	
neuta	b	
neuto	t	neuta
neuza	b	
neva	b	
newman	b	
neyra	b	
neyta	b	
nfuentes	t	cifuentes
niampira	b	
ñiampira	b	
niausa	b	
niauza	b	
nichery	t	vinchery
nichols	b	
niebles	b	
niedrano	t	medrano
nielsen	b	
niempira	t	niampira
niera	t	neira
nieta	t	nieto
nieto	b	
nieva	b	
niguel	t	miguel
niguepa	b	
niguez	t	miguez
niivan	b	
nilchez	b	
nilo	b	
nilton	t	milton
nimpaque	b	
ninco	b	
ninez	b	
niñi	t	nino
niñlo	t	nino
ninño	t	nino
niñño	t	nino
nino	b	
niño	b	
ñino	t	nino
ñiño	t	nino
niños	b	
nio	t	nino
nipo	b	
niquema	t	niquepa
niquepa	b	
nirebi	b	
nitla	t	nitola
nitola	b	
nitolas	t	nitola
niva	b	
nivan	b	
nivia	b	
niza	b	
nizme	b	
nmaria	t	maria
nno	t	nino
noa	b	
nobe	b	
nobsa	b	
nocave	t	conave
nocencio	t	inocencio
nocoa	t	novoa
nocobe	b	
nocobes	t	nocobe
nocote	b	
nocove	b	
nocua	b	
nogales	b	
noghuera	t	noguera
noguera	b	
noiquepa	t	niquepa
noiza	b	
nojica	t	mojica
nolano	b	
nolazco	b	
nomengue	b	
nomesque	b	
nomesqui	b	
nomezque	b	
nomezqui	t	nomezque
nonilla	t	bonilla
nono	b	
noño	t	nino
nonroy	t	monroy
nonsaque	t	nonzoque
nonsocua	b	
nonsoque	b	
nontian	t	nontien
nontiel	t	nontien
nontien	b	
nontoa	b	
nonzoque	b	
nope	b	
nopia	b	
nopove	b	
nopsa	b	
norato	b	
noratto	t	norato
norcote	t	morcote
nore	b	
norega	t	noriega
noreña	b	
noreno	t	moreno
noriega	b	
noriego	t	noriega
nosa	b	
nossa	b	
nota	b	
notien	b	
notoa	b	
notola	b	
nousan	b	
nova	b	
novao	t	nova
novas	t	nova
novitoa	b	
novo	t	novoa
novoa	b	
novson	b	
noy	b	
noya	t	moya
noza	b	
nranjo	t	naranjo
nucete	b	
nuchamocha	t	uchamocha
nuche	b	
nuhpaque	t	numpaque
numesque	b	
numesqui	t	numesque
numezqui	b	
numpaque	b	
numpaquen	t	numpaque
numpeque	t	numpaque
nuncira	b	
nunez	b	
nungo	b	
ñungo	b	
nuñia	b	
nunpaque	t	numpaque
nunsaba	b	
nunzaba	t	nunsaba
nupia	b	
nurillo	t	murillo
nustes	t	nustez
nustez	b	
nuta	b	
nutez	t	nustez
nuvan	b	
oaez	t	paez
oalacios	t	palacios
oaopeza	t	oropeza
obado	t	obando
oballe	t	ovalle
obando	b	
obanso	t	obando
obejero	t	ovejero
obeso	b	
obiedo	t	oviedo
obregon	b	
obregoso	b	
obregozo	t	obregoso
ocacion	b	
ocaciones	t	ocacion
ocampo	b	
ocampos	b	
ocaña	b	
ocano	b	
ocaño	b	
ocanteve	b	
ocariano	b	
ocasion	b	
ocasiones	b	
ocha	t	ochoa
ochao	t	ochoa
ochica	b	
ocho	t	ochoa
ochoa	b	
ochoia	t	ochoa
ocsmpo	t	campo
octavo	t	otavo
ocua	b	
odebrech	b	
odriguez	t	rodriguez
oedro	t	pedro
oereira	t	pereira
oerez	t	perez
oesca	t	pesca
ofonso	t	alfonso
ogliastri	b	
oicara	t	oicata
oicata	b	
oidor	b	
oilia	t	lilia
oimos	t	olmos
ointo	t	pinto
oirachican	t	pirachican
oivos	b	
oiza	t	loaiza
ojeda	b	
ojedas	t	ojeda
ojuela	t	orjuela
okia	b	
olano	b	
olarte	b	
olartte	t	olarte
olave	b	
olaya	b	
olayton	t	layton
olazas	t	plazas
olejua	b	
olguin	b	
olina	b	
olipio	t	alipio
olivar	b	
olivares	b	
olivarez	b	
olivaros	t	olivares
olivella	b	
olivera	b	
oliverios	t	oliveros
olivero	b	
oliveros	b	
oliverosd	t	oliveros
olivieri	b	
olivos	b	
ollin	b	
olmes	b	
olmister	b	
olmos	b	
olmoso	t	olmos
olonso	t	alonso
olvos	b	
oñate	b	
onatra	b	
oneira	b	
ong	b	
oniz	b	
ontibon	b	
ontreras	t	contreras
opayome	b	
operador	b	
opez	t	lopez
oquendo	b	
oramas	b	
orantes	t	morantes
orbegozo	b	
orbes	b	
ordenel	t	ordener
ordener	b	
ordez	t	orduz
ordoña	t	ordonez
ordoñes	b	
ordonez	b	
ordono	t	ordonez
ordoño	t	ordonez
ordonoez	t	ordonez
ordopes	t	ordonez
ordoquez	t	ordonez
ordriguez	t	rodriguez
orduña	b	
orduño	b	
ordus	t	orduz
orduz	b	
oreina	t	reina
oreja	b	
orejas	t	oreja
orejuela	b	
orellano	b	
orentire	b	
orentive	t	orentire
organista	b	
orito	b	
orizco	t	orozco
orjuela	b	
orjuella	t	orjuela
orjuelo	t	orjuela
ormasa	t	ormaza
ormaza	b	
ormazo	t	ormaza
ornaza	t	ormaza
ornero	b	
oro	b	
orobio	b	
orola	b	
oronado	t	coronado
oropera	b	
oropesa	b	
oropez	t	oropeza
oropeza	b	
oroposo	t	oropesa
oros	b	
orosco	b	
orosea	t	orozco
orostegui	b	
oroz	t	oros
orozco	b	
orozvo	t	orozco
orpeza	t	oropeza
orquijo	t	urquijo
orredor	t	corredor
orrego	b	
ortagate	t	ortegate
orteaga	t	arteaga
ortefon	t	ortegon
ortega	b	
ortegas	t	ortega
ortegate	b	
ortegon	b	
ortes	b	
ortez	b	
ortigoza	b	
ortin	b	
ortis	b	
ortix	t	ortiz
ortiz	b	
ortizx	t	ortiz
ortono	b	
ortozco	t	orozco
orttiz	t	ortiz
ortua	t	hortua
ortyz	t	ortiz
ortz	t	ortiz
orytiz	t	ortiz
osa	b	
osca	b	
oscategui	t	uscategui
ose	t	jose
osgame	t	usgame
osma	b	
osmos	b	
osnas	b	
osopeza	t	oropeza
osorio	b	
osorno	b	
ososrio	t	osorio
ospina	b	
ospino	b	
ospins	t	ospina
ospitia	t	espitia
ossa	b	
osses	t	ossa
osso	t	ossa
ostios	b	
ostor	t	ostos
ostos	b	
ostoz	t	ostos
osttos	t	ostos
osuga	b	
osuna	b	
otabra	b	
otalara	t	otalora
otalbaro	t	otalvaro
otalora	b	
otalota	t	otalora
otalvarez	b	
otalvaro	b	
otanil	b	
otavo	b	
oterino	b	
otero	b	
otiz	t	ortiz
otlora	t	otalora
otolora	t	otalora
otriz	t	ortiz
ouola	t	oyola
ovalle	b	
ovallos	b	
ovando	t	obando
ovarly	b	
ovedo	t	oviedo
ovejero	b	
ovejeros	t	ovejero
ovejrero	t	ovejero
ovenos	b	
oviedo	b	
ovies	t	oviedo
oyaga	b	
oyola	b	
oyuela	b	
ozak	b	
ozuna	b	
paarada	t	parada
paatino	t	patino
paba	b	
pabhuence	b	
pablador	b	
pablon	t	pabon
pablos	b	
pabon	b	
pabuena	b	
pacabaque	b	
pacaboque	t	pacabaque
pacacira	b	
pacagui	b	
pacaguy	b	
pacalagua	t	patalagua
pacaloguo	t	patalagua
pacaluca	b	
pacanahique	t	pacanchique
pacanchipe	t	pacanchique
pacanchique	b	
pacasira	b	
pacasuca	b	
pacateque	b	
pacativa	b	
pacatoque	t	pacateque
pacatuque	t	pacateque
pacavaque	t	pacabaque
pacavi	t	pacavita
pacavita	b	
pacaya	b	
pacazuca	b	
pache	b	
pacheca	t	pacheco
pacheco	b	
pachigay	b	
pachila	b	
pacho	b	
pachon	b	
pacini	b	
paco	b	
pacotiva	b	
pacvhon	t	pachon
padara	t	parada
padierna	b	
padill	t	padilla
padilla	b	
padraza	t	pedraza
padro	t	pedro
padron	b	
paecho	t	pacho
paella	b	
paeres	t	perez
paerez	t	perez
paez	b	
pagadora	b	
paguana	b	
paia	t	paiba
paiba	b	
paion	b	
paipa	b	
paipalla	t	paipilla
paipilla	b	
paipillac	t	paipilla
paipillla	t	paipilla
paiplla	t	paipilla
paiva	b	
paiz	b	
pajarito	b	
pajaro	b	
pajoy	b	
palacio	b	
palacioc	t	palacios
palacion	t	palacios
palacios	b	
palado	b	
palaencia	t	palencia
palcios	t	palacios
palechor	b	
palencia	b	
palenque	b	
palimino	t	palomino
palla	b	
pallares	b	
palleres	t	pallares
palma	b	
palmas	b	
palmieri	b	
palo	b	
paloimino	t	palomino
palom	t	paloma
paloma	b	
palomar	b	
palomares	b	
palomeque	b	
palomeras	t	palomares
palomina	t	palomino
palomini	t	palomino
palominio	t	palomino
palomino	b	
palomo	b	
palzas	b	
palzaz	b	
pam	t	pan
pamplona	b	
pamqueba	t	panqueba
pan	b	
panadero	b	
panagos	t	penagos
panbuena	b	
pancha	b	
panchalo	b	
panche	b	
pandilla	t	padilla
pando	b	
paneso	b	
panesso	b	
pang	b	
panguta	t	ponguta
paniaga	t	paniagua
paniagua	b	
panon	b	
panqueaba	t	panqueba
panqueba	b	
panqueva	b	
panquva	t	panqueva
pantano	b	
pantoja	b	
pantuja	t	pantoja
papagayo	b	
papipa	t	paipa
paracica	b	
parada	b	
parades	t	paredes
parado	b	
parales	b	
paralta	t	peralta
paramero	b	
paramo	b	
parara	t	parada
pararroyo	t	patarroyo
parasica	b	
pardo	b	
paredes	b	
paredess	t	paredes
paredez	t	paredes
parees	t	paredes
pareja	b	
parejas	t	pareja
parejo	b	
parez	b	
parga	b	
paricio	t	aparicio
parieta	b	
parilla	t	perilla
paris	b	
parko	b	
parmiño	b	
parodi	b	
parquez	b	
parra	b	
parrada	t	parada
parrade	t	parrado
parrado	b	
parrales	b	
parras	t	parra
parrea	t	parra
parro	t	parra
parroquiano	b	
parrra	t	parra
parrsa	t	parra
parz	t	parra
pas	t	paz
pasacho	t	pasachoa
pasachoa	b	
pasachoba	t	pasachoa
pasachoca	t	pasachoa
pasachova	t	pasachoa
pasaje	b	
pasaquira	b	
pasatoa	t	pasachoa
pasavala	b	
pascagaza	b	
pascua	b	
pascuali	b	
pascuas	b	
pasmino	b	
pasochoa	t	pasachoa
pasos	b	
pastas	b	
pasto	b	
pastos	b	
pastran	b	
pastrana	b	
pasuca	b	
patacon	b	
patalagua	b	
pataria	b	
pataroyo	t	patarroyo
patarrayo	t	patarroyo
patarro	t	patarroyo
patarrollo	t	patarroyo
patarrouyo	t	patarroyo
patarroyo	b	
patarrpyo	t	patarroyo
patarruyo	t	patarroyo
patell	b	
paterlina	t	paternina
patermina	t	paternina
paternina	b	
patina	t	patino
patini	t	patino
patino	b	
patiño	b	
patño	t	patino
patorroyo	t	patarroyo
patriño	t	patino
patron	b	
pauna	b	
pava	b	
pavas	b	
pavheco	t	pacheco
pavo	b	
pavon	t	pabon
pavor	t	pabon
pawz	t	paz
paya	b	
payan	b	
payares	b	
payne	b	
payune	b	
paz	b	
pdero	t	pedro
pea	t	paez
peaz	t	paez
pechenique	t	echenique
pechon	t	pachon
pedfo	t	pedro
pedfro	t	pedro
pedo	t	pedro
pedor	t	pedro
pedoroza	t	pedroza
pedrao	t	pedraos
pedraor	t	pedraos
pedraos	b	
pedraza	b	
pedrero	b	
pedreros	b	
pedro	b	
pedroa	t	pedroza
pedrop	t	pedro
pedros	t	pedro
pedroz	t	pedroza
pedroza	b	
pedrozo	b	
pedrp	t	pedro
pedrza	t	pedroza
peerez	t	perez
pefdro	t	pedro
peinado	b	
peito	b	
pela	b	
pelaes	t	pelaez
pelaez	b	
pelaya	b	
pelayo	b	
pelufo	b	
peña	b	
peñafiel	b	
peñafort	b	
penagos	b	
peñagos	t	penagos
peñalosa	b	
peñaloza	b	
peñaranda	b	
peñaraos	b	
peñarete	b	
peñas	b	
peñate	b	
penberty	b	
penea	t	perea
penon	b	
penqueba	t	panqueba
pentes	t	puentes
peñuela	b	
penzon	t	pinzon
pepinosa	b	
peqa	b	
per	b	
perafan	b	
peralata	t	peralta
perales	b	
peralta	b	
peranquive	t	piraquive
peraz	t	perez
peraza	b	
perdigan	b	
perdo	t	pedro
perdoma	t	perdomo
perdomo	b	
pere	t	perez
perea	b	
perefan	t	perafan
pereira	b	
pereiro	t	pereira
perella	t	perilla
peres	t	perez
perez	b	
perico	b	
pericon	t	perico
periila	t	perilla
periilla	t	perilla
perill	t	perilla
perilla	b	
periquino	b	
perlaza	b	
pero	t	pedro
peroza	b	
perrez	t	perez
perri	b	
perrilla	t	perilla
perry	b	
pertez	t	perez
pertuz	b	
perz	t	perez
pesa	b	
pesca	b	
pescador	b	
pescva	t	pesca
pesdraza	t	pedraza
pesilla	b	
pesraza	t	pedraza
pesro	t	pedro
petecua	b	
petri	b	
petro	b	
petroza	t	pedroza
petrucci	b	
pettifer	b	
peveda	t	poveda
pezca	b	
pholl	b	
piagas	b	
piamba	b	
piambo	b	
piamente	t	piamonte
piamento	t	piamonte
piamonte	b	
piazas	t	plazas
piazaz	t	plazas
piboche	b	
picagui	b	
picanchique	t	pacanchique
pichica	b	
pico	b	
picon	b	
picott	b	
picuariza	b	
pidache	t	pidiache
pidiache	b	
pidiachi	b	
pidiahi	t	pidiachi
pidrachi	t	pidiachi
piedrahita	b	
piedraita	t	piedrahita
piedraza	t	pedraza
pielrroja	b	
pierna	b	
piernagorda	b	
pierto	t	prieto
pieschacon	b	
pieto	t	prieto
pihedradita	t	piedrahita
pijaran	b	
pilco	b	
pilido	t	pulido
pilonieta	b	
pilonieza	b	
pimedo	t	pinedo
pimentel	b	
pimienta	b	
pimiento	b	
piña	b	
pinada	t	pineda
piñarete	b	
pinato	b	
pinchao	b	
pinda	t	pineda
pinea	t	pineda
pineada	t	pineda
pineda	b	
pinedas	t	pineda
pinedea	t	pineda
piñedes	b	
pinedo	b	
pinena	t	pineda
piñeres	b	
piñero	b	
piñeros	b	
pinill	t	pinilla
pinilla	b	
pinillas	t	pinilla
pinillla	t	pinilla
pinillna	t	pinilla
pinillo	b	
pinillos	b	
pinina	b	
pino	b	
pinson	t	pinzon
pinta	b	
pinto	b	
pintor	b	
piñuela	b	
pinzaon	t	pinzon
pinzn	t	pinzon
pinzo	t	pinzon
pinzon	b	
pinzonm	t	pinzon
pinzzon	t	pinzon
pira	b	
pirabague	b	
pirabaguen	b	
piraban	b	
pirabaque	t	pirabague
pirachica	t	pirachican
pirachican	b	
piracoa	b	
piracoca	b	
piracon	b	
piraconia	t	piracon
piracota	b	
piracua	b	
pirafan	t	pirajan
piragan	b	
piraganta	t	piragauta
piragata	t	piragauta
piragauta	b	
piragua	b	
piraguata	b	
piraguen	b	
piraguta	t	piragauta
pirajan	b	
pirajon	b	
piraligua	b	
piraloca	b	
piramanrique	b	
piramanrrique	t	piramanrique
piran	b	
piraneque	b	
piranguata	t	piraguata
piranja	b	
pirantive	b	
piraquieve	t	piraquive
piraquire	t	piraquive
piraquive	b	
piraraque	t	piravaque
pirasan	b	
pirataque	t	pirateque
pirateque	b	
piratoba	b	
piratobo	t	piratoba
piratova	b	
piratovo	t	piratova
piravague	b	
piravaguen	t	piravague
piravan	b	
piravaque	b	
piravitoba	b	
pirayan	b	
piraza	t	pirazan
pirazan	b	
pire	b	
piregauta	t	piragauta
pireto	t	prieto
piriache	b	
piriachi	b	
pirioche	t	piriache
piroteque	t	pirateque
pisco	b	
pita	b	
pitajan	t	pirajan
pitalua	b	
pitio	t	pito
pito	b	
pitta	b	
piza	b	
pizan	t	piza
pizarro	b	
pizco	b	
pizon	t	pinzon
pizza	b	
pjeda	t	ojeda
plata	b	
platero	b	
plato	b	
playonero	b	
plaza	b	
plazas	b	
plazasd	t	plazas
plazaz	t	plazas
plitin	b	
plmos	t	olmos
pnguta	t	ponguta
pnzon	t	pinzon
pobeda	t	poveda
poblador	b	
pobon	t	tobon
pocacira	t	pacacira
poche	b	
poches	b	
pochigay	b	
pocuna	b	
poguta	t	ponguta
pohl	b	
pola	t	polo
polanco	b	
polania	b	
polido	t	pulido
poliro	b	
polo	b	
poloche	b	
poludo	t	pulido
pomar	b	
pomare	b	
pomares	b	
pombo	b	
pompeyo	b	
ponare	b	
ponares	t	ponare
ponce	b	
ponche	b	
pongua	b	
ponguta	b	
ponti	b	
ponton	b	
popayan	b	
poprras	t	porras
poputa	b	
porciani	b	
pordomo	t	perdomo
pores	b	
porra	b	
porras	b	
porraz	t	porras
porres	b	
portala	b	
portela	b	
portella	t	portela
portilla	b	
portillo	b	
portla	b	
portocarrero	b	
portugues	b	
portuguez	b	
portuquez	t	portuguez
posada	b	
pose	b	
posso	b	
possso	t	posso
possu	t	posso
pote	b	
potes	b	
potilla	t	portilla
poveda	b	
povedae	t	poveda
povedda	t	poveda
povesa	t	poveda
pozo	b	
pozzi	b	
ppreciado	t	preciado
prada	b	
pradera	b	
pradilla	b	
prado	b	
prasca	b	
prciado	t	preciado
preciado	b	
precida	t	preciado
predraza	t	pedraza
pregonera	t	pregonero
pregonero	b	
preralta	b	
presiado	t	preciado
presidente	b	
presiga	b	
pretel	b	
prez	t	perez
priano	b	
prias	b	
prieta	t	prieto
prieto	b	
prima	b	
primiciero	b	
primos	b	
prito	b	
proano	b	
proaños	b	
prodigio	b	
prtiz	t	ortiz
psachoa	t	pasachoa
psifactoria	b	
puchicay	b	
puchigait	b	
puchigay	b	
pucuna	b	
puente	b	
puentes	b	
puents	t	puentes
puero	b	
puerta	b	
puertas	b	
puesta	b	
puht	b	
puig	b	
puin	b	
puint	b	
puinzon	t	pinzon
puis	b	
pula	b	
pulecio	b	
pulga	b	
pulgar	b	
pulgarin	b	
pulgueria	b	
pulid	t	pulido
pulida	t	pulido
pulide	t	pulido
pulido	b	
pulidso	t	pulido
pulio	t	pulido
puliso	t	pulido
pulñido	t	pulido
pulo	b	
pulqueria	b	
pumarejo	b	
puneme	b	
puntas	b	
puri	b	
puyana	b	
puyo	b	
pveda	t	poveda
pvnto	t	pinto
qarguello	t	arguello
qintana	t	quintana
quebedo	t	quevedo
quebradas	b	
quecano	b	
quecha	t	guecha
queguan	t	quenguan
queipo	b	
quejada	t	quezada
quemada	b	
quemba	b	
quendo	b	
quenguan	b	
quenza	b	
quepa	b	
quesada	b	
quesda	t	quezada
quevedo	b	
quezada	b	
quiacha	b	
quiasua	b	
quiazua	b	
quibay	b	
quica	b	
quicasaque	b	
quicazaque	t	quicasaque
quiceno	b	
quichanegua	b	
quiche	b	
quicosaque	t	quicasaque
quiedo	b	
quientero	t	quintero
quieroga	t	quiroga
quigua	b	
quijano	b	
quijntero	t	quintero
quika	b	
quila	b	
quilaguay	b	
quilindo	b	
quimbay	b	
quimbaya	b	
quimbayo	b	
quimbayos	t	quimbayo
quimboy	b	
quimicosis	b	
quinana	t	quintana
quinaya	b	
quinayas	t	quinaya
quinballo	t	quimbayo
quinbay	b	
quincasaque	t	quicasaque
quinceno	t	quiceno
quinchanegua	b	
quinchara	b	
quinche	b	
quinchia	b	
quincho	b	
quincos	b	
quineme	b	
quineos	t	guineos
quingue	b	
quinkasaque	b	
quinkos	b	
quino	b	
quiñones	b	
quiñonez	b	
quinoz	t	quiroz
quinseno	t	quiceno
quintana	b	
quintanilla	b	
quintanma	t	quintana
quintaria	t	quintana
quintero	b	
quinteto	t	quintero
quintetro	t	quintero
quintian	b	
quintiana	t	quintana
quintna	t	quintana
quintro	t	quintero
quintrro	t	quintero
quipasoca	b	
quique	b	
quiquiba	b	
quiquin	b	
quirama	b	
quirefe	b	
quirife	b	
quiroga	b	
quiroja	t	quiroga
quiros	t	quiroz
quirox	t	quiroz
quiroz	b	
quiseno	t	quiceno
quishpi	b	
quispe	t	quispi
quispi	b	
quitana	t	quintana
quiteno	t	quiceno
quitero	t	quintero
quitia	t	quitian
quitiam	t	quitian
quitian	b	
quito	b	
quivano	t	quijano
quivay	b	
quiza	b	
quizena	t	quiceno
quizua	t	quiazua
qumba	b	
quntero	t	quintero
qutian	t	quitian
quuiroga	t	quiroga
quuiroz	t	quiroz
raad	b	
raativa	t	rativa
raba	b	
raban	b	
rabello	b	
rabelo	b	
rabia	t	raba
rabon	b	
rabor	b	
racha	t	rocha
racharach	b	
rache	b	
racheco	t	pacheco
rachen	b	
raches	b	
rachez	b	
rachi	b	
rachid	b	
rachin	b	
racines	b	
racinez	b	
rada	b	
rael	b	
raga	t	ragua
ragua	b	
raigosa	b	
raigoso	b	
raigozo	b	
rairan	b	
rairez	t	ramirez
ramada	b	
ramairez	t	ramirez
ramas	b	
ramayo	t	tamayo
ramero	b	
rami	t	ramirez
ramierz	t	ramirez
ramireez	t	ramirez
ramires	t	ramirez
ramirez	b	
ramireza	t	ramirez
ramirirez	t	ramirez
ramirrez	t	ramirez
ramirz	t	ramirez
rammirez	t	ramirez
ramoirez	t	ramirez
ramom	t	ramon
ramon	b	
ramopn	t	ramon
ramos	b	
ramoz	t	ramos
randy	b	
rangel	b	
rangil	t	rangel
ranirez	t	ramirez
ranmirez	t	ramirez
ranzo	b	
raosa	t	rosa
rapira	t	reapira
raque	t	roque
raquejo	b	
raquetiva	b	
raquira	b	
rasa	t	rosa
rasmussen	b	
rativa	b	
rattiva	t	rativa
rava	b	
ravalo	t	ravelo
rave	t	ravelo
ravela	t	ravelo
ravelo	b	
raveo	t	ravelo
rayero	b	
rayo	b	
rayoozo	t	rayo
rberto	t	roberto
rco	t	rico
real	b	
reales	b	
realpe	b	
reapira	b	
reat	t	real
reatiga	b	
reay	b	
reaz	b	
rebellon	b	
reberto	t	roberto
rebolledo	b	
rebollero	t	rebolledo
rebolleso	t	rebolledo
recalde	b	
recanebo	b	
recaute	t	ricaurte
reclde	t	recalde
redon	t	rendon
redondo	b	
redriguez	t	rodriguez
regalado	b	
regis	b	
regua	t	ragua
reichel	b	
reina	b	
reinaldo	b	
reinaldpo	t	reinaldo
reinandlo	t	reinaldo
reinando	t	reinaldo
reinosa	b	
reinoso	b	
reinozo	t	reinoso
reiran	b	
reita	b	
reiunaldo	t	reinaldo
reiva	t	reina
rejes	t	rojas
rejo	b	
remache	b	
remith	b	
remolina	b	
renas	t	arenas
rendo	t	rendon
rendon	b	
renfijo	t	rengifo
rengifo	b	
renjifo	t	rengifo
renjigo	t	rengifo
renteria	b	
repizo	b	
requena	b	
requiniba	b	
requiniva	b	
rescanebo	t	rescanevo
rescanevo	b	
reses	b	
restrepo	b	
restrespo	t	restrepo
resttrepo	t	restrepo
retamoza	b	
retavisca	b	
retavista	t	retavisca
retiga	t	reatiga
retis	b	
retiz	b	
rettberg	b	
reuter	b	
reuto	b	
revelion	t	revellon
revellon	b	
revelo	b	
revera	t	rivera
revlo	t	revelo
revollo	b	
rewdondo	t	redondo
rey	b	
reyas	t	reyes
reyes	b	
reyesa	t	reyes
reyez	b	
reyna	b	
reynoso	b	
riaches	b	
riai	t	riay
riana	t	triana
riaño	b	
riaños	b	
riapira	b	
riapire	t	riapira
riaqo	b	
riasa	b	
riasco	t	riascos
riascos	b	
riatica	t	riativa
riatiga	b	
riativa	b	
riay	b	
ribero	b	
riberos	t	riveros
ribiano	t	rubiano
ribon	b	
ricalde	b	
ricambria	b	
ricanevo	t	riscanevo
ricarco	t	ricardo
ricarddo	t	ricardo
ricardo	b	
ricarod	t	ricardo
ricauerte	t	ricaurte
ricaurte	b	
ricaute	t	ricaurte
ricauter	t	ricaurte
rico	b	
ricon	t	rincon
ricrdo	t	ricardo
ricuaurte	t	ricaurte
ridardo	t	ricardo
ridriguez	t	rodriguez
rieger	b	
rigueredo	t	figueredo
rigueros	b	
rijas	t	rivas
rilvera	t	rivera
rimachi	b	
rimcon	t	rincon
rinaldy	b	
rinco	b	
rincom	t	rincon
rincon	b	
rinconadas	b	
rincos	b	
rincxon	t	rincon
rinta	b	
rio	b	
riobo	b	
riobueno	b	
riocampo	b	
riocrecio	b	
riodriguez	t	rodriguez
riofrio	b	
riomero	t	romero
rioncon	t	rincon
riopira	t	riapira
rioque	t	roque
rios	b	
ripe	b	
rippe	t	ripe
rique	b	
riscanebo	t	riscanevo
riscaneo	t	riscanevo
riscanero	t	riscanevo
riscanevo	b	
riscano	b	
risinque	t	rusinque
riso	b	
risos	t	riso
ritacuba	b	
ritiva	b	
ritman	b	
riuz	t	ruiz
rivadeneira	b	
rivadeneria	t	rivadeneira
rivas	b	
rivea	t	rivera
river	b	
rivera	b	
riveras	t	riveros
rivero	b	
riveros	b	
riviera	t	rivera
rivilla	b	
rivillas	t	rivilla
riza	b	
rizo	b	
rizza	b	
rjas	t	rojas
rlbles	t	robles
rmirez	t	ramirez
rmoreno	t	moreno
rncon	t	rincon
roa	b	
roajas	t	rojas
roajs	t	rojas
roam	t	roa
roasa	t	rosa
robaldo	b	
roballo	b	
robayo	b	
robba	b	
robblez	t	robles
robefto	t	roberto
robelto	b	
roberto	b	
robha	t	robba
robins	b	
robis	b	
roble	t	robles
robledo	b	
robles	b	
roblez	b	
robls	t	robles
robreto	t	roberto
robriguez	t	rodriguez
roc	t	roca
roca	b	
rocardo	t	ricardo
rocdriguez	t	rodriguez
rocero	b	
rocha	b	
roche	b	
rochem	t	roche
rochen	t	roche
rochereau	b	
roches	t	roche
rocillo	b	
rocines	b	
rocriguez	t	rodriguez
rodas	b	
roddriguez	t	rodriguez
rodelo	b	
roderiguez	t	rodriguez
rodero	b	
roderos	t	ronderos
rodez	b	
rodiguez	t	rodriguez
rodirguez	t	rodriguez
rodiriguez	t	rodriguez
rodirugez	t	rodriguez
rodiz	b	
rodkriguez	t	rodriguez
rodlriguez	t	rodriguez
rodon	t	rondon
rodrdiguez	t	rodriguez
rodreiguez	t	rodriguez
rodrgiuez	t	rodriguez
rodrguez	t	rodriguez
rodrifguez	t	rodriguez
rodrifuez	t	rodriguez
rodrigez	t	rodriguez
rodrigfuez	t	rodriguez
rodrigguez	t	rodriguez
rodrigiuez	t	rodriguez
rodrigo	b	
rodrigom	t	rodrigo
rodrigrez	t	rodriguez
rodrigtuez	t	rodriguez
rodriguaz	t	rodriguez
rodrigue	t	rodriguez
rodriguea	t	rodriguez
rodriguen	t	rodriguez
rodrigues	b	
rodriguez	b	
rodrigueza	t	rodriguez
rodriguezsa	t	rodriguez
rodriguezx	t	rodriguez
rodriguiez	t	rodriguez
rodrigurez	t	rodriguez
rodrigurz	t	rodriguez
rodriguuez	t	rodriguez
rodrihuez	t	rodriguez
rodriuez	t	rodriguez
rodruguez	t	rodriguez
rodruiguez	t	rodriguez
rodsriguez	t	rodriguez
rodtiguez	t	rodriguez
rofdriguez	t	rodriguez
rogas	t	rojas
rogeles	b	
rogelis	b	
rogriguez	t	rodriguez
roia	b	
roidriguez	t	rodriguez
roja	t	rojas
rojaas	t	rojas
rojano	b	
rojar	t	rojas
rojas	b	
rojo	b	
rojsa	t	rojas
roldan	b	
roldriguez	t	rodriguez
roler	b	
rolon	b	
roma	b	
roman	b	
romera	t	romero
romero	b	
romeroo	t	romero
romez	t	gomez
romon	t	ramon
romos	t	ramos
roncallo	b	
roncancancio	t	roncancio
roncanchio	t	roncancio
roncancio	b	
roncancios	t	roncancio
ronchaguila	t	ronchanquira
ronchanquira	b	
ronchaquira	b	
ronco	b	
roncon	t	rincon
rondero	t	ronderos
ronderos	b	
rondon	b	
ronohaquira	t	ronchaquira
rooberto	t	roberto
roodriguez	t	rodriguez
roojas	t	rojas
roomero	t	romero
ropdriguez	t	rodriguez
ropero	b	
ropoero	t	ropero
roque	b	
roquefeller	b	
rorero	t	forero
roriguez	t	rodriguez
rorres	t	torres
rorrez	t	torres
ros	t	rosa
rosa	b	
rosaa	t	rosa
rosac	t	rosa
rosai	t	rosa
rosal	b	
rosales	b	
rosao	b	
rosar	b	
rosas	b	
rosell	b	
roselli	b	
roselly	b	
rosely	b	
rosend	t	rosendo
rosendo	b	
rosero	b	
rosico	b	
rosillo	b	
roso	b	
rosollo	b	
rosriguez	t	rodriguez
rosro	t	roso
rosselli	b	
rossillo	t	rosillo
rosso	b	
rosters	b	
rota	b	
rotas	b	
rotavista	b	
rotemberg	b	
rotta	b	
rottemberg	b	
rounza	b	
roy	b	
roya	b	
royer	b	
royero	b	
royo	t	rayo
rozo	b	
rozzo	t	rozo
rpdriguez	t	rodriguez
rpjas	t	rojas
rpsa	t	rosa
rsa	t	rosa
rteyes	t	reyes
rua	b	
ruales	b	
ruan	b	
ruanan	b	
ruania	b	
ruano	b	
ruberto	t	roberto
rubet	b	
rubiamo	t	rubiano
rubiano	b	
rubiaqno	t	rubiano
rubiela	b	
rubio	b	
rubles	t	robles
rubriche	b	
rubuano	t	rubiano
ruda	b	
rudas	b	
rudriguos	t	rodrigo
rueda	b	
ruedas	b	
ruedo	t	rueda
ruera	b	
ruge	b	
rugeht	b	
rugel	b	
rugeles	b	
ruget	b	
rugeth	b	
rugs	b	
ruha	t	rua
rui	t	ruiz
ruia	t	ruiz
ruis	t	ruiz
ruiz	b	
ruje	b	
rujer	t	ruje
rujes	t	ruje
runio	b	
runza	b	
rurmen	t	kurmen
ruse	b	
rusero	t	rosero
rusi	b	
rusinke	b	
rusinque	b	
russi	b	
russinke	b	
russinque	b	
russsi	t	russi
russu	t	russi
russy	b	
rusy	t	russy
rutllant	b	
ruvio	t	rubio
ruyer	b	
ruz	b	
rvera	t	rivera
ryes	t	reyes
saa	b	
saaavedra	t	saavedra
saab	b	
saanchez	t	sanchez
saandoval	t	sandoval
saavadra	t	saavedra
saavedra	b	
saavedrach	t	saavedra
saavedro	t	saavedra
saavedrsa	t	saavedra
saaverda	t	saavedra
saba	b	
sabaat	t	sabat
sabah	t	sabat
sabala	b	
saballet	b	
sabarain	b	
sabas	b	
sabat	b	
sabatto	b	
sabay	b	
sabba	b	
sabi	b	
sabogal	b	
saboya	b	
sabra	b	
sabrain	t	sabarain
sabria	b	
sabrica	b	
sacanome	t	saganome
sacedo	t	salcedo
sachez	t	sanchez
sachica	b	
sacon	b	
sacristan	b	
sacristian	t	sacristan
sadat	b	
sadino	t	sandino
saegura	t	segura
saen	t	saenz
saens	t	saenz
saenz	b	
saeoud	b	
saez	t	saenz
saffon	b	
safford	b	
safra	b	
sagadome	t	saganome
saganome	b	
saganone	t	saganome
sagobal	t	sabogal
sague	b	
sahenz	t	saenz
saidiza	b	
saiduta	b	
sainea	b	
sainz	t	saenz
sairas	t	sairias
sairias	b	
sais	t	saiz
saisa	b	
saiz	b	
saiza	b	
sajoneo	t	sajonero
sajonero	b	
sala	b	
salado	b	
salamaca	t	salamanca
salamamca	t	salamanca
salamanaca	t	salamanca
salamanc	t	salamanca
salamanca	b	
salamca	t	salamanca
salamnca	t	salamanca
salamo	t	solano
salamon	t	salomon
salananca	t	salamanca
salanca	t	salamanca
salanmanca	t	salamanca
salano	t	solano
salanueva	b	
salanuevo	t	salanueva
salarzar	t	salazar
salas	b	
salasar	t	salazar
salavarrieta	b	
salaz	t	salas
salazar	b	
salazr	t	salazar
salbador	t	salvador
salbeldo	t	salcedo
salbornoz	t	albornoz
salcedo	b	
salcero	t	salcedo
salceso	t	salcedo
saldaña	b	
saldarriaga	b	
saldearraga	t	saldarriaga
saldica	b	
saldna	b	
saldoval	t	sandoval
saldua	b	
salem	b	
saleme	t	salem
sales	b	
salgadao	t	salgado
salgado	b	
salgados	t	salgado
salgar	b	
salguer	t	salguero
salguera	t	salguero
salguero	b	
sali	b	
salijnas	t	salinas
salimon	t	salomon
salina	b	
salinas	b	
salledo	t	salcedo
sallo	b	
salmamanca	t	salamanca
salmanca	t	salamanca
salom	b	
saloman	t	salomon
salomom	t	salomon
salomon	b	
saloza	b	
salsedo	t	salcedo
saltamontes	b	
saltarin	b	
saltilla	b	
saltos	t	santos
salvador	b	
salvadro	t	salvador
samabria	t	sanabria
samaca	b	
samaco	t	samaca
samana	b	
samaniego	b	
samaniegop	t	samaniego
sambogal	t	sabogal
sambony	b	
sambrano	b	
sambraño	t	zambrano
samdino	t	sandino
samenez	b	
samgumo	b	
samin	b	
samora	t	zamora
sampayo	b	
sampedro	b	
samper	b	
samudio	b	
sana	b	
sanabia	t	sanabria
sanabra	t	sanabria
sanabrai	t	sanabria
sanabraia	t	sanabria
sanabria	b	
sanabrias	t	sanabria
sanabruia	t	sanabria
sanachez	t	sanchez
sananabria	t	sanabria
sanaria	t	sanabria
sanatos	t	santos
sanbrano	t	zambrano
sanbria	t	sanabria
sancehz	t	sanchez
sancha	t	suancha
sanche	t	sanchez
sanchea	t	sanchez
sanches	b	
sanchez	b	
sanchezp	t	sanchez
sanchezs	t	sanchez
sanchsz	t	sanchez
sancjez	t	sanchez
sandales	b	
sandaval	t	sandoval
sandel	b	
sandiniz	b	
sandino	b	
sandobal	t	sandoval
sandoval	b	
sandovel	t	sandoval
sandovl	t	sandoval
sandovla	t	sandoval
sandoya	b	
sandua	b	
sanenz	t	saenz
sanez	t	saenz
sanguino	b	
sanguña	b	
sanhez	t	sanchez
sanin	b	
sanjuan	b	
sanmartin	b	
sanmiguel	b	
sanocha	b	
sanpablo	b	
sanpedro	b	
santacoloma	b	
santacruz	b	
santafe	b	
santamaria	b	
santana	b	
santander	b	
santanilla	b	
santefa	t	santafe
santefe	t	santafe
santi	b	
santiago	b	
santibañez	b	
santiesteban	b	
santigao	t	santiago
santillana	b	
santiste	t	santisteban
santisteban	b	
santiz	b	
santocoloma	b	
santodomingo	b	
santofimio	b	
santoque	b	
santos	b	
santoyo	b	
santuario	b	
santucci	b	
sanudio	t	samudio
sanudo	b	
sañudo	t	sanudo
sanz	t	saenz
sanza	b	
saoba	t	saba
saosa	t	sosa
sapulveda	t	sepulveda
sapuy	b	
sapuyes	b	
saqnchez	t	sanchez
saque	b	
sarabanda	b	
sarabia	b	
sarache	b	
saracipa	b	
sarasa	b	
sarasty	b	
sarate	t	zarate
saravia	b	
saray	b	
saraza	b	
sarazo	t	saraza
sarco	b	
sarfan	b	
sargento	b	
sariano	b	
sarmeinto	t	sarmiento
sarmient	t	sarmiento
sarmiento	b	
sarmientos	t	sarmiento
sarmineto	t	sarmiento
sarminto	t	sarmiento
sarmrmiento	t	sarmiento
sarrazola	b	
sarria	b	
sarta	b	
sas	b	
sasa	b	
sastoque	b	
sastre	b	
sasunaga	t	susunaga
satiba	t	sativa
satisteban	t	santisteban
sativa	b	
satizabal	b	
satoba	b	
satoque	b	
satos	t	santos
satova	t	satoba
satre	t	sastre
sauarez	t	suarez
saucedo	t	salcedo
sauchez	t	sanchez
saucho	t	siaucho
saurez	t	suarez
sava	b	
savala	b	
savarain	t	sabarain
savedra	t	saavedra
sawenz	t	saenz
say	b	
sayah	b	
sayer	b	
sayo	b	
saza	b	
scarpeta	b	
scarpetta	b	
scerri	b	
schellt	b	
scheneider	b	
schenker	b	
schibli	b	
schlumbeger	b	
schneider	b	
schoch	b	
schrader	b	
schubler	b	
schulz	b	
schuter	b	
schuvayre	b	
schwarz	b	
schwora	b	
scott	b	
sdanchez	t	sanchez
sea	b	
seanswin	b	
seas	b	
seba	b	
secion	b	
seco	b	
secua	b	
sedano	b	
sedeno	t	cedeno
sedeño	t	cedeno
sedono	b	
seerano	t	serrano
segavia	t	segovia
segia	b	
segindo	t	segundo
segovia	b	
segua	b	
seguera	b	
seguia	t	segua
segunco	t	segundo
segunde	t	segundo
segundo	b	
segundop	t	segundo
segungo	t	segundo
segura	b	
seguras	b	
seguro	t	segura
seidiza	b	
seija	b	
seijas	t	seija
sejejoa	t	senejoa
selemin	b	
seles	b	
selpuveda	t	sepulveda
selva	b	
sema	b	
sembaqueba	b	
semo	b	
sendales	t	cendales
seneca	b	
senejoa	b	
senejoc	t	senejoa
sension	t	ascencion
sepeda	t	cepeda
sepilveda	t	sepulveda
sepulvada	t	sepulveda
sepulvda	t	sepulveda
sepulveda	b	
sepulvedas	t	sepulveda
sepulvelda	t	sepulveda
sepulvrda	t	sepulveda
sepuveda	t	sepulveda
sequeda	t	sequera
sequera	b	
serano	t	serrano
sereno	b	
seriano	b	
sermiento	t	sarmiento
serna	b	
seron	t	ceron
serpa	b	
serrada	b	
serranao	t	serrano
serrano	b	
serrato	b	
serrrano	t	serrano
servalo	b	
servantes	t	cervantes
serventi	b	
servera	b	
servula	b	
sesar	t	cesar
sestoque	b	
setuain	b	
severiche	b	
sevilla	b	
sevillano	b	
sfeir	b	
sgundo	t	segundo
sgura	t	segura
shalosky	b	
shdloski	t	shalosky
shenider	b	
shibli	b	
shin	b	
shonvald	b	
siabato	b	
siabatto	b	
siaca	b	
siacacha	t	sichaca
siacha	b	
siacho	t	siaucho
siachoque	b	
siacnhoque	t	siachoque
siacuamia	b	
siadato	t	siabato
siagame	t	siatame
siagato	t	siabato
siahato	t	siabato
siahucho	b	
siancho	b	
sianpira	b	
siarez	t	suarez
siata	b	
siatama	b	
siatame	b	
siatana	t	siatama
siatoba	b	
siaucho	b	
siauchoa	t	siaucho
siavato	t	siabato
siaz	b	
sibato	t	siabato
sibeta	b	
sibo	b	
sibocha	t	siboche
siboche	b	
sicacha	b	
sicaha	t	sicacha
sichaca	b	
sichaco	t	sichaca
sicua	b	
sicuamia	b	
sicuania	t	sicuamia
sicuaria	t	sicuamia
sicuariza	b	
sieera	t	sierra
siempia	t	siempira
siempira	b	
sienpira	t	siempira
siera	t	sierra
sieraa	t	sierra
sierra	b	
sierrra	t	sierra
siervo	b	
sifuentes	t	cifuentes
sigua	b	
sigucho	t	siaucho
silava	t	silva
silbaquera	t	simbaguera
silbestre	t	silvestre
silbva	t	silva
silca	b	
silv	t	silva
silva	b	
silvan	t	silva
silvestre	b	
simanca	b	
simanco	t	simanca
simbaguera	b	
simbaqueba	b	
simbaquera	t	simbaqueba
simbaqueva	b	
simbasica	b	
simen	b	
simijaca	b	
simmonds	b	
simnds	t	simmonds
simonds	t	simmonds
simpira	t	siempira
sinbaqueba	t	simbaqueba
sindicue	b	
sineon	b	
sinisterra	b	
sinmos	t	simmonds
sinucho	b	
sinvaqueva	t	simbaqueba
sinvasica	t	simbasica
sipa	t	zipa
sipacon	t	cipacon
sipamocha	b	
sipasuca	b	
siranicicua	t	ciranicicua
sirata	b	
sirrea	t	sierra
sirvo	t	siervo
sisa	b	
sislema	b	
sisneros	t	cisneros
sissa	b	
sistiva	b	
sitachan	t	sotachan
sitara	b	
situa	b	
siuran	b	
siuta	b	
siva	t	silva
sivestre	t	silvestre
sivo	b	
siza	b	
skiner	b	
slacedo	t	salcedo
slamanca	t	salamanca
slavador	t	salvador
slazar	t	salazar
slcedo	t	salcedo
sllva	b	
slva	t	silva
slvestre	t	silvestre
small	b	
smikkers	b	
smith	b	
smorfe	b	
smorrz	t	smorz
smorz	b	
smuz	b	
snabria	t	sanabria
snachez	t	sanchez
snchez	t	sanchez
soacha	b	
soan	b	
soancha	b	
soariano	b	
soarique	b	
soaterna	b	
soba	b	
socadaguay	t	socadagui
socadagui	b	
socadaqui	b	
socadogui	t	socadagui
socama	b	
socano	b	
socaragui	t	socadagui
socha	b	
sochas	t	socha
soche	t	socha
sochimilca	b	
sochimiles	b	
socho	t	socha
socimo	b	
socomgocha	b	
socota	b	
soelva	t	selva
soer	t	soler
sofanor	b	
sogamone	b	
sogamos	t	sogamoso
sogamoso	b	
sola	b	
solamanca	t	salamanca
solana	b	
solanilla	b	
solano	b	
solao	t	solano
solaque	b	
solarte	b	
solarza	t	solorza
soldano	b	
sole	t	soler
soleda	t	soledad
soledad	b	
soler	b	
solera	b	
solere	t	solera
solero	t	solera
soles	b	
solio	t	soto
solis	b	
soliz	t	solis
solomon	t	salomon
solon	b	
solorza	b	
solorzano	b	
solosa	b	
soloza	b	
solozano	b	
solva	b	
soma	b	
sombredera	b	
sombredero	b	
sombrerero	b	
sommer	b	
sona	b	
sondoval	t	sandoval
sope	b	
sopho	b	
sopo	b	
sora	b	
soraca	b	
soracai	t	soraca
soracipa	b	
soraquive	b	
sorazipa	b	
soriano	b	
sorocipa	b	
sorro	t	zorro
sorza	b	
sosa	b	
sose	t	sosa
sosoto	t	soto
sosraca	t	soraca
sossa	b	
sostoque	t	sastoque
sot	t	soto
sota	b	
sotaban	b	
sotachan	b	
sotaqira	t	sotaquira
sotaquira	b	
sotelo	b	
sotera	b	
sotgo	t	soto
soto	b	
sotoba	t	sotoban
sotoban	b	
sotomomte	t	sotomonte
sotomonte	b	
sotomontes	b	
sotquira	t	sotaquira
soza	b	
spancer	b	
spindola	b	
spinel	b	
spolidore	b	
sricaurte	t	ricaurte
srodriguez	t	rodriguez
ssanchez	t	sanchez
ssocha	t	socha
stafford	b	
steele	b	
stepa	b	
sterling	b	
steves	b	
stillffrid	t	stillfried
stillfried	b	
storres	t	torres
straessle	b	
stunkel	b	
sua	b	
suabita	b	
suacha	b	
suache	b	
suacho	b	
suade	b	
suaerez	t	suarez
suaez	t	suarez
suan	b	
suancha	b	
suaneha	b	
suarca	b	
suarea	t	suarez
suares	b	
suarewz	t	suarez
suarez	b	
suareza	t	suarez
suarique	b	
suarte	b	
suartez	t	suarez
suascun	t	suescun
suaso	b	
suaterna	b	
suatrez	t	suarez
suavita	b	
suavitas	t	suavita
suaz	t	suaza
suaza	b	
suazo	b	
suba	b	
subato	b	
subero	b	
subieta	b	
sucergia	t	sucerquia
sucerquia	b	
sucr	t	sucre
sucre	b	
sucres	b	
sueca	b	
suecun	t	suescun
sueita	b	
suel	b	
suelta	b	
sueraz	t	suarez
suerez	t	suarez
suesa	t	suesca
suesca	b	
suescu	t	suesca
suescun	b	
suespes	b	
sugura	t	segura
suica	b	
suiga	t	suica
sulbara	b	
sulim	b	
sulpeda	b	
suluaga	t	zuluaga
sulvestre	t	silvestre
suna	b	
sunce	b	
supalano	b	
supanieve	b	
supanteve	b	
supantive	t	supanteve
suparez	t	suarez
supata	b	
supatene	b	
supelano	b	
supelveda	t	sepulveda
supulveda	t	sepulveda
suraez	t	suarez
surez	t	suarez
surincho	b	
surique	t	suarique
susa	b	
susano	b	
susatama	b	
suscun	t	suescun
suse	b	
susecun	t	suescun
suspantere	b	
suspe	b	
susped	t	suspe
suspedes	t	cespedes
suspes	b	
suspesa	b	
suspez	b	
suspuntele	b	
sustampira	b	
sustanpira	t	sustampira
susunaga	b	
suta	b	
sutachan	b	
sutanchan	b	
sutaneme	b	
sutha	b	
sutolines	b	
sutta	b	
suza	b	
suzarez	t	suarez
suzrez	t	suarez
suzunuaga	t	susunaga
szemelveisz	b	
szemelveiz	b	
ta	b	
taazona	t	tarazona
tabacan	b	
tabacco	t	tabaco
tabaco	b	
tabaduiza	t	tibaduiza
tabares	b	
tabarez	b	
tabera	b	
taboada	b	
tabora	t	taborda
taborda	b	
tacilla	b	
tacon	b	
tacora	b	
tadazona	t	tarazona
tadioy	b	
tafur	b	
tafurh	t	tafur
taita	b	
taite	t	taita
tajero	t	talero
takemiche	b	
taladiche	b	
talaviche	b	
talcio	b	
talermo	b	
talero	b	
talher	b	
tamajo	t	tamayo
tamara	b	
tamaran	b	
tamasco	b	
tamayo	b	
tambo	b	
tami	b	
tamo	t	tambo
tamyo	t	tamayo
tanarrosa	t	tunarrosa
tancon	t	toncon
tandio	t	tandioy
tandioy	b	
tangarife	b	
tango	b	
tangua	b	
tanjo	t	tenjo
taparcua	b	
tapasco	b	
tapia	b	
tapial	t	tapia
tapias	b	
tapie	t	tapia
tapiero	b	
tapieros	t	tapiero
tapon	b	
taprero	b	
taque	b	
taquiva	b	
tarache	b	
taradie	b	
taran	b	
taraza	b	
tarazo	b	
tarazona	b	
taron	b	
tarquino	b	
tarres	t	torres
tarro	b	
tarzona	t	tarazona
tascano	b	
tascon	b	
tatar	b	
taucher	b	
tauta	b	
tautiva	b	
tavar	t	tovar
tavares	b	
tavarez	b	
tavera	b	
taverra	t	tavera
tay	b	
tayo	b	
te	b	
teatin	b	
teatino	b	
tebar	t	tobar
tedis	b	
tegedor	b	
tegria	b	
tegua	b	
tehuta	b	
tejada	b	
tejeda	b	
tejedor	b	
tejedro	t	tejedor
tejeiro	b	
telero	b	
telles	b	
tellez	b	
tello	b	
tena	b	
teneche	b	
tenesaca	b	
tengua	t	tegua
tenjo	b	
tenorio	b	
tensa	b	
tenso	b	
tenza	b	
tequia	b	
tequita	b	
teran	b	
teraza	b	
ternera	b	
terreros	b	
terselich	b	
tetay	b	
tetelua	b	
tetelva	t	tetelua
teusaba	b	
teusillo	t	trujillo
teuta	b	
tevero	b	
tgarzon	t	garzon
theran	b	
thorschmidt	b	
tiabduiza	t	tibaduiza
tiaten	b	
tiatino	t	teatino
tibabija	b	
tibacan	t	tibagan
tibacay	t	tibacuy
tibacuy	b	
tibaduisa	t	tibaduiza
tibaduiza	b	
tibaduza	t	tibaduiza
tibagan	b	
tibai	t	tibay
tibala	b	
tibaldo	b	
tibambre	b	
tibamosa	b	
tibamosca	b	
tibamoso	b	
tibamozo	t	tibamoso
tibana	b	
tibaque	b	
tibaquera	t	tibaquira
tibaquira	b	
tibaram	b	
tibarija	t	tibavija
tibasosa	b	
tibata	b	
tibaudiza	t	tibaduiza
tibavija	b	
tibavila	t	tibavija
tibavisco	b	
tibawue	t	tibaque
tibay	b	
tibidor	b	
tibobija	t	tibabija
tibocha	b	
tiboche	b	
tiboque	b	
ticora	b	
tiedra	b	
tiendra	t	tiedra
tierradentro	b	
tifazo	b	
tiga	b	
tigab	t	tiga
tigreros	b	
tija	b	
tijaca	t	tinjaca
tijanci	t	tojanci
tijano	b	
tijaro	b	
tijo	b	
tilano	b	
timana	b	
timbambre	t	tibambre
timpaca	b	
tinaco	b	
tinedo	b	
tineo	t	tinedo
tinjaca	b	
tinjaco	t	tinjaca
tinoco	b	
tintin	b	
tiorres	t	torres
tiosaba	t	tiusaba
tipacoca	b	
tipacoque	b	
tipasoca	b	
tipazoca	b	
tipazola	t	tipazoca
tique	b	
tira	b	
tirado	b	
tirano	b	
tirga	b	
tiria	b	
tirres	t	torres
tiulfo	t	tulfo
tiusaba	b	
tiuso	t	tiuzo
tiuzo	b	
tivabija	t	tibavija
tivaduija	t	tibaduiza
tivamosa	t	tibamosa
tivata	t	tibata
tivavija	t	tibavija
tivay	b	
tividor	b	
tlo	b	
toaneca	b	
toarazona	t	tarazona
toba	b	
tobacia	b	
tobaco	t	tabaco
tobacuy	b	
tobaduiza	t	tibaduiza
tobar	b	
tobaria	b	
tobasia	b	
tobasora	t	tobasura
tobasura	b	
tobazura	t	tobasura
tobiam	t	tobian
tobian	b	
tobio	b	
tobito	b	
tobitos	t	tobito
tobo	b	
tobon	b	
tobos	b	
tobvar	t	tovar
toca	b	
tocaria	b	
tocarrucho	t	tocarruncho
tocarrumcho	t	tocarruncho
tocarruncho	b	
tocaruncho	t	tocarruncho
tocasuche	b	
toche	b	
tocon	b	
tocora	b	
tocua	b	
tofanci	t	tojanci
tofansi	t	tojanci
tojan	b	
tojanci	b	
tojansi	t	tojanci
tojuelo	b	
tole	b	
toledo	b	
tolero	t	talero
toliz	b	
tollez	t	tellez
tolon	b	
tolosa	b	
toloza	b	
toluza	t	toloza
tomarosa	b	
tombe	b	
tomero	t	romero
tomislav	b	
toncan	t	toncon
toncom	t	toncon
toncon	b	
toner	b	
tones	t	toner
tong	b	
tongua	t	tangua
tonoco	t	tinoco
tonocobia	t	tonocolia
tonocolia	b	
tonsanci	t	tonsasci
tonsasci	b	
tonusco	b	
toores	t	torres
tooro	t	toro
topaga	b	
topasco	b	
topia	b	
topiero	t	tapiero
toquica	b	
torache	b	
toracipa	b	
torado	b	
toras	b	
torazona	t	tarazona
torcado	b	
torcido	b	
tordecilla	t	torrecilla
torers	t	torres
tores	t	torres
torifio	b	
tornero	b	
torneros	t	tornero
toro	b	
toroche	t	torache
toros	t	toro
torquino	t	tarquino
torra	t	torres
torrado	b	
torralba	b	
torras	b	
torre	b	
torrealba	b	
torrealva	b	
torrecilla	b	
torree	t	torres
torrejano	b	
torrenegra	b	
torrers	t	torres
torres	b	
torresa	t	torres
torresc	t	torres
torrez	b	
torrijos	b	
torrres	t	torres
torrs	t	torres
toscano	b	
tosse	b	
totaitine	t	totaitive
totaitive	b	
totative	t	totaitive
tova	t	tovar
tovacia	b	
tovar	b	
tovaria	t	tobaria
tovasura	t	tobasura
tovat	t	tovar
tozcano	t	toscano
tpias	t	tapias
tprres	t	torres
trache	t	torache
translaviña	b	
traslaviña	b	
tratin	b	
trebilteck	b	
trejo	t	trejos
trejos	b	
trelos	t	trejos
trespalacios	b	
tria	b	
triana	b	
trianos	b	
tribaldos	b	
tricci	b	
trigo	b	
trigos	b	
trijillo	t	trujillo
trilleras	b	
trillo	t	trillos
trillos	b	
trinadad	t	trinidad
trinana	t	triana
trindad	t	trinidad
trinidad	b	
trinidada	t	trinidad
tristancho	b	
tristanho	t	tristancho
trivales	b	
triver	b	
triviño	b	
triyos	b	
troncoso	b	
troyano	b	
trsitancho	t	tristancho
truca	b	
trucco	b	
truco	b	
truga	t	truca
trujilla	t	trujillo
trujillo	b	
trujullo	t	trujillo
trullo	b	
tuai	t	tuay
tuana	b	
tuay	b	
tubacuy	t	tibacuy
tuesta	b	
tufy	b	
tuiran	b	
tuiza	b	
tujuelo	b	
tula	b	
tulay	b	
tulcan	b	
tulfo	b	
tulivara	b	
tulkan	b	
tumarosa	t	tunarosa
tumay	b	
tumoi	b	
tumqay	t	tumay
tunarosa	b	
tunaroza	b	
tunarrosa	b	
tunarroza	t	tunarrosa
tundama	b	
tundero	b	
tunjacipa	b	
tunjano	b	
tunjazipa	t	tunjacipa
tunjuelo	b	
tunpanteve	t	tupanteve
tupantebe	t	tupanteve
tupantene	t	tupanteve
tupanteve	b	
tupanteves	t	tupanteve
turca	b	
turcio	b	
turco	b	
turga	b	
turizo	b	
turley	b	
turmeque	b	
turriago	b	
turvan	b	
tuta	b	
tuua	b	
tuy	b	
tuzaba	b	
ualberto	t	alberto
ualla	t	cualla
uanay	t	guanay
uanto	b	
ubaque	b	
ubate	b	
ucasia	b	
ucastegui	t	uscategui
ucero	b	
uchamocha	b	
uchamoncha	t	uchamocha
uchima	b	
uchubo	b	
uchuvo	b	
ucros	b	
ucross	t	ucros
ucuenga	b	
ujavan	b	
ulabarri	b	
ulabarry	b	
ulcue	b	
ullaban	b	
ullavan	b	
ullo	t	ulloa
ulloa	b	
uloa	t	ulloa
ulrike	b	
ultria	b	
umaña	b	
umapa	b	
umay	b	
umba	b	
umbacia	b	
umbacio	t	umbacia
umbarela	t	umbarila
umbariba	b	
umbarila	b	
umbarilla	t	umbarila
umbarina	b	
umbarita	b	
umbariva	t	umbariba
umbasia	b	
umbita	b	
umda	b	
umeje	b	
umibio	t	unibio
unate	b	
uncacia	t	uncaria
uncaria	b	
unchamoncha	t	uchamocha
unda	b	
undurraga	b	
uneme	b	
ungo	b	
uni	b	
unibio	b	
unidio	b	
univio	b	
unrisa	t	unriza
unriza	b	
unrrisa	t	unriza
unrriza	t	unriza
unubio	b	
upa	b	
upegui	b	
ura	b	
uragama	b	
uran	b	
urango	t	durango
urazan	b	
urazn	t	urazan
urbamo	t	urbano
urbano	b	
urbina	b	
urbino	b	
urcua	b	
urda	b	
urdaneta	b	
urego	t	urrego
ureña	b	
ureta	b	
urete	b	
urguiso	b	
uriam	t	urian
urian	b	
uribe	b	
uricacha	b	
uricochea	t	uricoechea
uricoechea	b	
urientive	t	urintive
urieta	b	
urintibe	t	urintive
urintive	b	
urisa	t	uriza
uritive	t	urintive
uriza	b	
urquijo	b	
urra	t	urrea
urrea	b	
urreco	t	urrego
urrega	t	urrego
urrego	b	
urresty	b	
urriago	b	
urriola	b	
urritia	t	urrutia
urrutia	b	
urueña	b	
urueta	b	
urvano	t	urbano
urzola	b	
usa	b	
usactegui	t	uscategui
usaque	b	
usaquen	b	
usaquin	t	usaquen
uscategue	t	uscategui
uscategui	b	
uscateguy	t	uscategui
uscaten	b	
uscateque	t	uscategui
uscatequi	t	uscategui
useda	b	
useta	t	useda
usgame	b	
usma	t	usme
usme	b	
usmen	t	usme
ussa	b	
usscategui	t	uscategui
ustariz	b	
ustegui	b	
ustez	t	nustez
usuche	b	
usuga	b	
usuriaga	b	
utrera	b	
uunado	b	
uva	b	
uyaban	b	
uyasaba	b	
uyasan	b	
uyazan	b	
uyuban	b	
uzaban	t	uyaban
uzacategui	t	uscategui
uzaquen	b	
uzeta	b	
uzgame	b	
vaaca	t	vaca
vaaliente	t	valiente
vabuena	t	valbuena
vaca	b	
vacares	b	
vacarez	t	vacares
vacca	b	
vad	b	
vaderrama	t	valderrama
vaegara	t	vergara
vaesa	b	
vaez	t	baez
vaga	t	vega
vagas	t	vargas
vahos	b	
vaillancourt	b	
valaguera	t	balaguera
valancia	t	valencia
valandia	t	velandia
valar	b	
valasquez	t	velasquez
valazco	t	velasco
valbuana	t	valbuena
valbuena	b	
valbuna	t	valbuena
valcarcel	b	
valcarcer	t	valcarcel
valcazar	t	balcazar
valdeleon	b	
valderama	t	valderrama
valderra	t	valderrama
valderraa	t	valderrama
valderrama	b	
valderrema	t	valderrama
valderrma	t	valderrama
valdes	b	
valdez	b	
valdian	t	valdion
valdion	b	
valdiri	b	
valdivia	b	
valdivieso	b	
valdrrama	t	valderrama
valejo	t	vallejo
valencia	b	
valenciano	b	
valenica	t	valencia
valentim	t	valentin
valentin	b	
valenzuela	b	
valer	b	
valera	b	
valeriano	b	
valero	b	
valerrama	t	valderrama
valest	b	
valeta	b	
valets	t	valest
valiente	b	
valklares	b	
valla	b	
vallares	b	
vallarez	t	vallares
vallarino	b	
valle	b	
valleja	t	vallejo
vallejo	b	
vallejos	t	vallejo
vallen	b	
vallerino	b	
valles	b	
valoe	b	
valor	b	
valsquez	t	vasquez
valvarcel	t	valcarcel
valverde	b	
valvuena	b	
vanefgas	t	vanegas
vanega	t	vanegas
vanegas	b	
vanegaz	t	vanegas
vangio	b	
vanoli	b	
vaos	b	
vaquen	b	
vaquero	b	
vaquez	t	vasquez
vaquijo	t	vaquiro
vaquiro	b	
vara	t	vera
varacaldo	t	baracaldo
varaceta	b	
varagas	t	vargas
varags	t	vargas
varajas	b	
varas	t	vargas
varauta	b	
varcalcel	t	valcarcel
varcarcel	t	valcarcel
varela	b	
varelas	t	varela
varelo	t	varela
vareno	b	
varg	t	vargas
varga	t	vargas
vargaas	t	vargas
vargal	t	vargas
vargar	t	vargas
vargara	t	vergara
vargas	b	
vargasa	t	vargas
vargaz	b	
vargs	t	vargas
vargsa	t	vargas
varhgas	t	vargas
varinas	b	
varon	b	
vasalla	t	vasallo
vasallo	b	
vasaves	b	
vasco	b	
vasgas	t	vargas
vasqquez	t	vasquez
vasque	t	vasquez
vasques	b	
vasquez	b	
vasrgas	t	vargas
vasuqez	t	vasquez
vatiga	b	
vative	b	
vauero	t	vaquero
vavuena	t	valbuena
vazconez	b	
vazques	t	vasquez
vazquez	b	
vcargas	t	vargas
vctor	t	victor
veargas	t	vargas
vecente	t	vicente
vedoya	t	bedoya
vedugo	t	verdugo
vega	b	
vegal	t	vega
vegara	t	vergara
vegas	b	
veha	t	vega
veintemillo	b	
veira	b	
vejeres	b	
vela	b	
veladia	t	velandia
velalcar	t	belalcazar
velalcarcel	t	belalcazar
velalcazar	t	belalcazar
velanadia	t	velandia
velanda	t	velandia
velandai	t	velandia
velandaia	t	velandia
velandi	t	velandia
velandia	b	
velandoia	t	velandia
velania	t	velandia
velanida	t	velandia
velas	b	
velasco	b	
velascom	t	velasco
velascop	t	velasco
velasque	t	velasquez
velasques	t	velasquez
velasquez	b	
velasquz	t	velasquez
velazco	b	
velazque	t	velasquez
velazques	t	velasquez
velazquez	b	
velbuena	t	valbuena
velero	t	valero
veles	t	velez
velez	b	
velgara	t	vergara
velgel	t	vergel
velhbehr	b	
velilla	b	
vella	t	avella
vellamil	t	villamil
vellasco	t	velasco
vellejo	t	vallejo
velndia	t	velandia
velosa	b	
veloza	b	
vely	b	
velzaco	t	velasco
venadillo	b	
veñandia	t	velandia
venavides	b	
venavidez	t	venavides
vence	b	
venegas	b	
venencia	t	valencia
venera	b	
venero	b	
vente	b	
ventes	b	
ventez	b	
vento	b	
ventura	b	
vepeda	t	cepeda
vera	b	
veragara	t	vergara
verano	b	
verbal	t	verbel
verbel	b	
verdugo	b	
vergaño	b	
vergara	b	
vergas	t	vargas
vergel	b	
vergell	t	vergel
vergudo	t	verdugo
verjan	b	
vermeo	t	bermeo
vernal	t	bernal
vero	b	
veron	t	ceron
versa	t	vera
versalles	b	
versel	t	vergel
vesga	b	
vhavez	t	chavez
viacha	b	
viafara	b	
viajan	b	
viana	b	
vianca	t	viancha
viancha	b	
viasan	b	
viasus	b	
viatela	b	
viausus	t	viasus
viayan	t	viajan
viazus	t	viasus
vicaria	b	
vicas	b	
vicenmte	t	vicente
vicente	b	
vicentes	b	
vicents	b	
vichery	t	vinchery
vicotr	t	victor
victior	t	victor
victo	t	victor
victoa	t	victor
victor	b	
victoria	b	
victro	t	victor
vicyor	t	victor
vidal	b	
vidales	b	
vide	t	vides
vides	b	
videz	t	vides
viecente	t	vicente
vieda	t	viedma
viedma	b	
viera	b	
viesma	b	
vieto	b	
viga	b	
vigiane	b	
vigot	b	
vigoth	b	
vigoya	b	
viguez	b	
viguie	t	viguez
viictor	t	victor
viillamil	t	villamil
vija	b	
vijilda	b	
vila	t	villa
vilalba	t	villalba
vilalmizar	t	villamizar
vilalte	t	villate
vilardy	b	
vilate	t	villate
vilbao	t	bilbao
vilbuena	t	valbuena
vilela	b	
vill	t	villa
villa	b	
villabona	b	
villabos	t	villalobos
villacres	b	
villada	b	
villadiego	b	
villafañe	b	
villafrader	t	villafrades
villafrades	b	
villafradez	t	villafrades
villagran	b	
villagrande	b	
villagron	t	villagran
villail	b	
villalba	b	
villalobos	b	
villalovos	t	villalobos
villalta	b	
villalua	t	villalva
villalva	b	
villamar	b	
villamarin	b	
villami	t	villamil
villamicar	t	villamizar
villamil	b	
villamill	t	villamil
villamin	t	villamil
villamir	t	villamil
villamizar	b	
villamol	t	villamor
villamor	b	
villan	t	millan
villanil	t	villamil
villanueba	t	villanueva
villanueva	b	
villanuieva	t	villanueva
villar	b	
villaraga	b	
villareaga	b	
villareal	b	
villarraga	b	
villarreal	b	
villarte	b	
villaruel	t	villareal
villasana	b	
villata	b	
villate	b	
villater	t	villate
villatte	t	villate
villava	t	villalba
villaveces	b	
villazon	b	
villegas	b	
villero	b	
villesca	b	
villescas	t	villesca
villeta	b	
villicia	b	
villita	t	villeta
villkamarin	t	villamarin
villklanueva	t	villanueva
villmil	b	
villon	b	
villota	b	
vilod	b	
viloria	b	
vilva	b	
vilvad	b	
vilvao	b	
viña	b	
vinasco	b	
vinazco	b	
vincherry	t	vinchery
vinchery	b	
vinchira	b	
vincus	b	
vinuesa	b	
viola	b	
viracacha	b	
viracocha	t	viracacha
virbiescas	b	
virgues	b	
virguesz	t	virgues
virguez	b	
virviesca	t	virviescas
virviescas	b	
visa	b	
viscaino	b	
viscaya	b	
visctor	t	victor
visente	t	vicente
viso	b	
visral	b	
vistor	t	victor
visviescas	t	viviescas
vital	b	
viterbo	b	
vitolo	b	
viuche	b	
viuda	b	
viullamil	t	villamil
viuna	b	
vivares	b	
vivas	b	
vivctor	t	victor
vivero	b	
viveros	b	
vivias	b	
viviescas	b	
viviezcas	t	viviescas
vivtoria	t	victoria
vixctor	t	victor
vixtor	t	victor
vizcaino	b	
vlasquez	t	velasquez
vlero	t	valero
voctor	t	victor
voegell	b	
vollert	b	
vovelo	b	
vqalaguera	t	balaguera
vragas	t	vargas
vrgas	t	vargas
vuelvas	b	
vuictor	t	victor
vul	b	
vulferssthauvisky	b	
vulfersthvuski	b	
vulsky	b	
vurgos	t	burgos
vyaban	b	
waked	b	
wakeo	t	waked
waker	b	
waldonado	t	maldonado
waldron	b	
wall	b	
wallis	b	
waltero	t	walteros
walteros	b	
walterosc	t	walteros
walters	t	walteros
wandurraga	b	
wanumen	b	
warren	b	
wayne	b	
wecha	b	
weiss	b	
wene	b	
wiancha	t	viancha
wiches	t	wilches
wicon	b	
widerkehr	b	
widerkely	t	widerkehr
wiesner	b	
wiest	b	
wilchaz	t	wilches
wilche	t	wilches
wilches	b	
wilchez	b	
wilchhez	t	wilches
wild	b	
wiles	b	
wilhicm	b	
willamil	b	
wills	b	
winterdal	b	
wintingan	t	wittingham
winz	b	
wirtenberger	b	
wis	b	
wittingham	b	
wittinghan	b	
wittinhan	t	wittinghan
wittmer	b	
wlches	t	wilches
wlteros	t	walteros
wolff	b	
wouwer	b	
wseguera	t	seguera
wu	b	
wualteros	t	walteros
wuanumen	b	
wuitthigan	t	wittinghan
wunumen	b	
wyckoff	b	
xcarlos	t	carlos
yabrudy	b	
yacab	b	
yacari	b	
yagama	b	
yagana	t	yagama
yaguar	b	
yaguara	b	
yague	b	
yaguive	t	yaquive
yahuar	b	
yakab	b	
yamayosa	b	
yamayusa	b	
yamayuza	b	
yandi	b	
yanes	b	
yañes	b	
yanez	b	
yañez	b	
yanguan	b	
yanken	b	
yanque	b	
yanquen	b	
yaquen	b	
yaquibe	b	
yaquire	t	yaquive
yaquive	b	
yara	b	
yaruro	b	
yasguaran	b	
yate	b	
yatte	b	
yauripoma	b	
yaya	b	
yayay	b	
yaye	b	
yayes	b	
yayo	b	
yazo	b	
yebrahil	b	
yega	t	vega
yela	b	
yelil	b	
yemayusa	b	
yemayuza	b	
yepes	b	
yepez	b	
yerena	b	
yguavita	t	guavita
yinjaca	b	
yoldy	b	
yomayusa	b	
yomayuza	b	
yonda	b	
yoneche	t	goneche
yopasa	b	
yoposa	b	
yordan	b	
yorgui	b	
yorguin	b	
young	b	
younp	t	young
yunado	b	
yunia	t	yunis
yunis	b	
yunnis	b	
yuren	b	
yurey	b	
yurgaky	b	
yusepe	b	
yustin	b	
yustre	b	
yustres	b	
yusunguaira	b	
zabala	b	
zabaleta	b	
zabaranda	b	
zabria	t	sabria
zacadagui	b	
zacipa	b	
zae	b	
zaenz	b	
zaes	t	saenz
zafra	b	
zaganome	b	
zain	b	
zainea	b	
zais	b	
zaiz	b	
zalanueva	b	
zalasar	t	salazar
zalatiel	b	
zalazar	t	salazar
zaldua	b	
zalgado	t	salgado
zamabia	b	
zamabrano	t	zambrano
zamara	t	zamora
zambano	t	zambrano
zambarno	t	zambrano
zambo	b	
zambrana	t	zambrano
zambrano	b	
zamidio	t	zamudio
zammora	t	zamora
zamora	b	
zamudio	b	
zanabria	t	sanabria
zanbrano	t	zambrano
zanchez	t	sanchez
zandalio	b	
zandoval	t	sandoval
zanguino	b	
zanguña	b	
zañiga	t	zuniga
zanin	t	sanin
zapa	b	
zapan	b	
zapata	b	
zapatero	b	
zaque	b	
zarabanda	b	
zarabia	b	
zarare	b	
zarasa	t	zaraza
zarate	b	
zaraza	b	
zarazo	t	zaraza
zarazte	t	zarate
zarela	t	varela
zarrate	t	zarate
zarrazola	t	sarrazola
zarta	b	
zarza	b	
zastoque	b	
zatizabal	t	satizabal
zatoba	t	satoba
zavala	b	
zayas	b	
zayed	b	
zaza	t	izaza
zea	b	
zeas	b	
zegua	b	
zemanete	b	
zequera	t	cequera
zerda	b	
zerna	t	serna
zetaquira	t	sotaquira
zetina	b	
zhi	b	
zhongming	b	
zigua	b	
zimbaqueba	t	simbaqueba
zipa	b	
zipacon	b	
zipamocha	b	
zipaquira	b	
zipasuca	b	
zipazuca	b	
ziranicima	b	
zisa	b	
ziza	b	
zmora	t	zamora
zocadagui	b	
zolamo	t	solano
zooro	t	zorro
zoque	b	
zora	b	
zoracipa	b	
zorasipa	b	
zorazipa	b	
zordoba	t	cordoba
zorrilla	b	
zorrillo	b	
zorro	b	
zosrro	t	zorro
zotaquira	b	
zotaquirta	t	zotaquira
zotelo	t	sotelo
zoto	t	soto
zsemelous	b	
zsemelveis	t	szemelveisz
zua	b	
zuabieta	t	zubieta
zubieta	b	
zubiria	b	
zubuieta	t	zubieta
zuentes	t	fuentes
zuescun	t	suescun
zuleta	b	
zuletz	t	zuleta
zuluaga	b	
zuniga	b	
zuta	b	
zutta	b	
zuyaban	b	
zwinggi	b	
